prozent	percent
geschichte	story
frage	question
frauen	women
kinder	children
wasser	water
daten	data
verstehen	understand
zukunft	future
afrika	africa
schule	school
energie	energy
natur	nature
indien	india
buch	book
sprechen	talk
projekt	project
lernen	learn
wissenschaft	science
mutter	mother
körper	body
bild	picture
geschichten	stories
stadt	city
frau	woman
menschlichen	human
stunden	hours
universum	universe
fragen	questions
spielen	play
gesellschaft	society
sprache	language
antwort	answer
ziemlich	pretty
regierung	government
gehört	heard
eltern	parents
verändern	change
zellen	cells
erfahrung	experience
woche	week
kultur	culture
bauen	build
haus	house
vater	father
freunde	friends
wochen	weeks
krebs	cancer
tiere	animals
unterschied	difference
hören	hear
falsch	wrong
essen	food
kopf	head
fühlen	feel
prozess	process
soziale	social
gebäude	building
jahrhundert	century
einfach	simply
gemeinschaft	community
erinnern	remember
gesundheit	health
denken	thinking
beginnen	start
bildung	education
glücklich	happy
teilen	share
modell	model
technologien	technologies
lösung	solution
stück	piece
schwer	hard
freund	friend
vereinigten	united
hoffe	hope
gelernt	learned
verhalten	behavior
struktur	structure
wirtschaft	economy
mitgefühl	compassion
oberfläche	surface
spiel	game
fähigkeit	ability
bücher	books
plötzlich	suddenly
städte	cities
unglaublich	incredibly
schulen	schools
stimme	voice
wahrheit	truth
tausende	thousands
regeln	rules
erklären	explain
herausforderung	challenge
kindern	kids
realität	reality
medien	media
schreiben	write
krankheit	disease
kosten	cost
gebaut	built
armut	poverty
wissenschaftler	scientists
schrieb	wrote
beispiele	examples
lösen	solve
markt	market
umwelt	environment
größe	size
lehrer	teachers
aufmerksamkeit	attention
zugang	access
ozean	ocean
dorf	village
alter	age
schönheit	beauty
entwicklung	development
schneller	faster
beziehung	relationship
zeug	stuff
bringen	bring
reise	journey
produkt	product
architektur	architecture
objekt	object
mitte	middle
verändert	changed
bakterien	bacteria
passierte	happened
gewalt	violence
erfolg	success
medizin	medicine
englisch	english
pflanzen	plants
entscheidungen	decisions
programm	program
absolut	absolutely
nachrichten	news
stunde	hour
wachstum	growth
unmöglich	impossible
wachsen	grow
universität	university
schwierig	difficult
entwickeln	develop
materialien	materials
bereit	ready
amerikanischen	american
wand	wall
gefühl	feeling
sicherheit	security
lösungen	solutions
projekte	projects
amerikaner	americans
glück	happiness
entwickelt	developed
komplett	completely
öffentlichen	public
rolle	role
kreativität	creativity
zelle	cell
leidenschaft	passion
krankenhaus	hospital
gründe	reasons
produkte	products
regierungen	governments
büro	office
freiheit	freedom
tochter	daughter
einzelne	single
komplexität	complexity
netzwerk	network
werkzeuge	tools
physik	physics
konzept	concept
entschieden	decided
bäume	trees
straße	street
vertrauen	trust
studien	studies
neuronen	neurons
westen	west
infrastruktur	infrastructure
vergessen	forget
sterne	stars
messen	measure
armen	poor
gesellschaften	societies
arzt	doctor
kollegen	colleagues
arten	kinds
schließlich	finally
materie	matter
modernen	modern
osten	east
verkaufen	sell
farbe	color
verbunden	connected
schön	beautiful
gesetz	law
politischen	political
überleben	survive
natürliche	natural
buchstäblich	literally
bühne	stage
erfunden	invented
richtung	direction
frieden	peace
roten	red
wahl	choice
preis	price
fähigkeiten	skills
geschrieben	written
atmosphäre	atmosphere
intelligenz	intelligence
unglaubliche	incredible
objekte	objects
boden	ground
konferenz	conference
ärzte	doctors
meilen	miles
antworten	answers
menschheit	humanity
verständnis	understanding
verantwortung	responsibility
erwarten	expect
behandlung	treatment
karriere	career
fisch	fish
verbindung	connection
mathematik	mathematics
entdeckt	discovered
maschinen	machines
bewusstsein	consciousness
verbringen	spend
ergebnis	result
künstler	artists
schützen	protect
erkennen	recognize
näher	closer
schwester	sister
organisationen	organizations
qualität	quality
größer	bigger
bleiben	stay
präsident	president
modelle	models
langsam	slowly
schwarze	black
warten	wait
gelegenheit	opportunity
beziehungen	relationships
aktivität	activity
herauszufinden	figure
gestern	yesterday
beginnt	starts
treffen	meet
sprachen	languages
phänomen	phenomenon
spiele	games
folgen	follow
reihe	series
beine	legs
wissenschaftliche	scientific
identität	identity
bedeutung	meaning
institutionen	institutions
risiko	risk
entscheidung	decision
kalifornien	california
starb	died
leisten	afford
10.000	10,000
weißen	white
krankheiten	diseases
größte	biggest
unterschiede	differences
verrückt	crazy
sauerstoff	oxygen
grün	green
herausforderungen	challenges
konzentrieren	focus
bruder	brother
landwirtschaft	agriculture
echte	real
getötet	killed
bildschirm	screen
artikel	article
schmerz	pain
galaxie	galaxy
geschäft	business
möglichkeit	possibility
generationen	generations
bewusst	aware
inspiriert	inspired
gesetze	laws
schlimmer	worse
führen	lead
geschaffen	created
spricht	talks
entscheiden	decide
verbessern	improve
verbracht	spent
perspektive	perspective
riesige	huge
gefährlich	dangerous
farben	colors
fortschritt	progress
polizei	police
gesamte	entire
werkzeug	tool
bedingungen	conditions
persönliche	personal
straßen	streets
elektrizität	electricity
bezahlen	pay
klingt	sounds
beweise	evidence
behandeln	treat
entwicklungsländern	developing
vielfalt	diversity
einkommen	income
kaffee	coffee
komplexe	complex
ecke	corner
erstaunlich	amazing
temperatur	temperature
gewinnen	win
dunkle	dark
erreichen	reach
mexiko	mexico
kommunikation	communication
bauern	farmers
babys	babies
geschwindigkeit	speed
gesprochen	talked
hilft	helps
unterstützen	support
entdecken	discover
ansatz	approach
erzählt	tells
stimmen	voices
netzwerke	networks
führt	leads
kulturen	cultures
australien	australia
fahren	drive
möglichkeiten	possibilities
maus	mouse
jahrzehnt	decade
jungen	boys
druck	pressure
chemikalien	chemicals
linien	lines
gemeinden	communities
leute	guys
moralische	moral
nationen	nations
fernsehen	television
westlichen	western
insel	island
landschaft	landscape
lebt	lives
quelle	source
kirche	church
führte	led
verstanden	understood
wüste	desert
perfekt	perfect
durchschnittliche	average
statistiken	statistics
internationalen	international
vergleichen	compare
lektion	lesson
verbinden	connect
erfolgreich	successful
teuer	expensive
erklärt	explains
großmutter	grandmother
flugzeug	airplane
erfahrungen	experiences
sitzen	sitting
brücke	bridge
wirtschaftlichen	economic
soldaten	soldiers
deutsch@@ land	germany
aufregend	exciting
krank	sick
überzeugen	convince
basiert	based
südafri@@ ka	south
medikament	drug
fantastisch	fantastic
kindheit	childhood
löcher	holes
größten	largest
vorfahren	ancestors
kräfte	forces
stuhl	chair
überrascht	surprised
verantwortlich	responsible
mikro@@ ben	micro@@ bes
prinzipien	principles
erklärung	explan@@ ation
nimmt	takes
gefühle	feelings
afrikanischen	african
einfluss	impact
bürger	citizens
nachbarn	neighb@@ ors
wuchs	grew
punkte	dots
fuß	foot
fehler	mistake
gesund	healthy
hintergrund	background
gerechtigkeit	justice
prinzip	principle
fleisch	meat
medizinische	medical
entworfen	designed
10@@ 0.000	100,000
gefängnis	prison
chines@@ ische	chinese
o@@ hren	e@@ ars
religi@@ onen	religi@@ ons
brasili@@ en	brazil
produktion	production
reaktion	response
psych@@ ologie	psychology
chemie	chemistry
sp@@ ät	late
verlassen	leave
eigenschaften	properties
märkte	markets
erkannte	realized
köni@@ g	king
bringt	brings
gene@@ tische	genetic
waffen	weapons
plasti@@ k	plastic
entdeckung	discovery
ziele	goals
ägyp@@ ten	eg@@ y@@ pt
verbindungen	connections
teilchen	particles
geburt	birth
sorgen	worry
schuhe	shoes
jahrzehn@@ ten	decades
lebte	lived
ar@@ mee	army
geheimnis	secret
einfach@@ heit	simpli@@ city
lebenden	living
kompliziert	complicated
blu@@ men	flo@@ wers
tanz	dance
affen	mon@@ keys
verkauft	sold
gemeinsam	common
veröffentlicht	published
wel@@ traum	space
dach	roof
pfund	pounds
fluss	river
politiker	politicians
reisen	travel
zusammenarbeit	collaboration
brachte	brought
strategie	strategy
reich	rich
ge@@ kauft	bought
geschieht	happening
bibliothe@@ k	library
bezahlt	paid
vorstell@@ ungskraft	imagination
sicht	view
ein@@ geladen	invited
auf@@ geregt	excited
zu@@ cker	sugar
kultur@@ elle	cultural
kapit@@ el	chap@@ ter
wählen	choose
kümmern	care
län@@ dlichen	rural
sonnen@@ licht	sun@@ light
garten	garden
ständig	constantly
liter@@ atur	liter@@ ature
schritte	steps
verlust	loss
exi@@ stenz	existence
schaute	looked
verhindern	prevent
weiterhin	continue
stark	strong
zä@@ hne	teeth
epide@@ mie	epidemic
auto@@ matisch	auto@@ matically
mehr@@ heit	majority
überrasch@@ ung	surprise
wahrnehmung	perception
gespielt	played
ge@@ holfen	helped
wel@@ ten	worl@@ ds
in@@ dischen	indian
öko@@ system	ecosystem
fühlt	feels
überzeugt	convinced
möglichen	sorts
kohlen@@ stoff	carbon
größeren	larger
rus@@ s@@ land	russi@@ a
frank@@ reich	fr@@ ance
kampagne	campaign
geräte	devices
produziert	produced
wichtiger	importantly
norden	north
philosoph@@ ie	philosoph@@ y
schwe@@ den	swe@@ den
pfer@@ d	horse
wettbewerb	competition
kü@@ che	kitchen
bes@@ essen	obs@@ essed
sammeln	collect
erwachsenen	adults
situationen	situations
autis@@ mus	autis@@ m
existieren	exist
ökon@@ omen	econom@@ ists
has@@ sen	hate
präsentation	pres@@ entation
tragen	wear
geburt@@ stag	birthday
bedro@@ hung	threat
persönlich	personally
mäch@@ tig	powerful
lächeln	s@@ mile
chem@@ ische	chemical
schlafen	sleep
akzeptieren	accept
existiert	exists
gelöst	solved
zeichnen	draw
kämpfen	fight
glob@@ alisierung	glob@@ alization
forscher	researchers
biolog@@ ische	biological
reduzieren	reduce
diskussion	discussion
platt@@ form	platform
janu@@ ar	janu@@ ary
zeitung	newspaper
nachhal@@ tige	sustainable
phy@@ sischen	physical
archite@@ kt	architect
zählen	count
nachbar@@ schaft	neighborhood
ausdruck	expression
bei@@ bringen	teach
glück@@ licher	happ@@ ier
w@@ ände	walls
hilfe	aid
vorteil	advantage
meinung	opini@@ on
zerstör@@ ung	destruction
liebte	loved
arab@@ ischen	arab
führer	leaders
leistung	performance
gebäu@@ den	buildings
gewebe	tissue
er@@ wärmung	warming
gleich@@ ung	equ@@ ation
schiff	ship
klassen@@ zimmer	classroom
mil@@ ch	milk
techni@@ ken	techniques
bei@@ gebracht	taught
trinken	drink
einzelnen	individual
bezug	terms
unternehmen	businesses
schwimmen	swim
opfer	vic@@ ti@@ ms
ner@@ vö@@ s	nervous
nachhal@@ tigkeit	sustain@@ ability
transpar@@ enz	transpar@@ ency
brust@@ krebs	breast
ab@@ en@@ dessen	dinner
satz	sentence
vertraut	familiar
afrikan@@ er	afri@@ cans
gel@@ b	yellow
priv@@ aten	private
ko@@ hle	coal
haufen	bunch
richtungen	direc@@ tions
definieren	define
verbreiten	spread
belo@@ hnung	reward
vorstellung	notion
faszinier@@ end	fascinating
sinne	senses
vor@@ teile	benefits
küste	coast
sch@@ am	sh@@ ame
hit@@ ze	heat
besuchen	visit
aufgaben	tas@@ ks
identi@@ fizieren	identify
zweck	purpose
schul@@ ter	shoul@@ der
häuser	houses
terror@@ ismus	terror@@ ism
schaden	damage
abend	ton@@ ight
the@@ orien	theor@@ ies
grundlegende	basic
chirur@@ g	surge@@ on
wurz@@ eln	roots
stand	stood
verbrechen	crime
ehe@@ mann	husband
beschrei@@ bt	descri@@ bes
erinn@@ erungen	memor@@ ies
technik	techni@@ que
schlimm@@ sten	worst
sektor	sector
grenzen	boundar@@ ies
mitta@@ gessen	lunch
holz	wood
dunkel@@ heit	dar@@ k@@ ness
interessan@@ ter@@ weise	interest@@ ingly
selts@@ ame	strange
mus@@ keln	mus@@ cles
lich@@ ter	lights
organis@@ mus	organis@@ m
maßstab	scale
fla@@ sche	bottle
pflan@@ ze	plant
titel	ti@@ tle
erwähnt	mentioned
bemerkens@@ werte	remarkable
universi@@ täten	universi@@ ties
berü@@ hren	touch
interak@@ tion	interaction
schwan@@ z	tail
kapit@@ alismus	capit@@ alism
effizi@@ enz	efficiency
lebenser@@ war@@ tung	expec@@ tan@@ cy
außergewöhn@@ liche	extraordinary
begriff	term
spiegel	mirror
febru@@ ar	febru@@ ary
erd@@ be@@ ben	earth@@ qua@@ ke
schutz	protection
entdeck@@ ungen	disco@@ ver@@ ies
zusä@@ tzlich	addition
weltweit	worldwide
de@@ z@@ ember	dec@@ ember
viertel	quar@@ ter
effektiv	effective
ver@@ glichen	compared
mikrosk@@ op	microscop@@ e
tür@@ ke@@ i	tur@@ key
schwierigkeiten	trouble
wa@@ hlen	elec@@ tions
ändern	changing
erwar@@ tungen	expec@@ tations
stärker	stron@@ ger
o@@ hr	ear
analyse	analysis
tasche	po@@ cket
letzte	final
bürger@@ meister	ma@@ yo@@ r
mar@@ ke	brand
e@@ he	marriage
erschaffen	creating
wohl@@ stand	wealth
selten	r@@ ar@@ ely
lachen	lau@@ gh
buchstab@@ en	letters
faszin@@ iert	fascin@@ ated
bri@@ tischen	british
konzep@@ te	concep@@ ts
beteili@@ gt	involved
pazi@@ fi@@ k	pacific
offen@@ heit	open@@ ness
arbeiter	workers
völlig	totally
künst@@ liche	artificial
überrasch@@ end	surprising
ereig@@ nisse	events
verletz@@ lichkeit	vulner@@ ability
verschwinden	disappe@@ ar
stif@@ tung	foundation
bedeu@@ tete	meant
ernä@@ hren	feed
zerstören	destro@@ y
religiö@@ sen	religious
unterhaltung	entertain@@ ment
physiker	physi@@ c@@ ist
berü@@ hmt	famous
effe@@ kte	effects
produk@@ tivität	produ@@ c@@ tivity
nennt	calls
groß@@ vater	grand@@ father
kontakt	contact
tief@@ er	deeper
glaub@@ te	believed
anwen@@ dungen	appli@@ cations
in@@ fiziert	infe@@ cted
genie@@ ßen	enjoy
zunehmen@@ d	increasingly
tö@@ chter	dau@@ gh@@ ters
besondere	special
zuhören	listen
führung	leadership
emis@@ sionen	emissions
verteilung	distribution
skulp@@ tur	sculp@@ ture
europä@@ ischen	european
aktivitäten	activi@@ ties
strahlung	radiation
chirur@@ gen	surge@@ ons
bi@@ ologen	bi@@ ologists
lieder	songs
erwartet	expected
proz@@ esse	processes
geome@@ trie	geome@@ try
brü@@ der	brothers
sprach	spoke
optimi@@ stisch	optimi@@ stic
wahrscheinlichkeit	prob@@ ability
stücke	pieces
innova@@ tionen	innova@@ tions
ausstellung	exhi@@ bi@@ tion
wol@@ ke	cloud
ernährung	diet
wächst	growing
zerstört	destro@@ yed
fett@@ lei@@ bi@@ gkeit	o@@ bes@@ ity
anwenden	apply
stärke	strength
langwei@@ lig	bor@@ ing
proben	sam@@ ples
nach@@ mit@@ tag	after@@ noon
sele@@ ktion	sele@@ ction
atom@@ energie	nuclear
zeichen	sign
gemü@@ se	vege@@ tables
sch@@ western	si@@ sters
inseln	is@@ lands
scho@@ kol@@ ade	cho@@ col@@ ate
verlangen	desire
flug@@ ha@@ fen	air@@ port
ge@@ däch@@ tnis	memory
irgendwann	eventually
ver@@ sprechen	promise
fahr@@ zeuge	vehi@@ cles
ä@@ thi@@ op@@ ien	ethi@@ op@@ ia
frü@@ hl@@ ing	spring
bio@@ sphäre	bio@@ sphere
köni@@ g@@ in	queen
zug	train
aus@@ rü@@ stung	equipment
fällt	falls
künstler@@ in	artist
neugi@@ er@@ ig	curious
fertig	finished
laden	store
werbung	adverti@@ sing
klini@@ k	clin@@ ic
wohl@@ befinden	well-@@ being
vorberei@@ tet	prepared
bestimmen	deter@@ mine
ak@@ tion	action
nach@@ frage	demand
stabili@@ tät	st@@ ability
kinder@@ sterb@@ lichkeit	mortality
schwier@@ iger	harder
versuch	attemp@@ t
verg@@ nü@@ gen	pleasure
dienst@@ leistungen	services
autor@@ ität	auth@@ ority
teilt	shares
saß	sat
versuche	trials
schei@@ tern	fail
pre@@ mier@@ minister	minister
erfinden	inv@@ ent
beschäftigt	bus@@ y
gemäl@@ de	painting
liegt	lies
po@@ cken	small@@ po@@ x
schwer@@ kraft	gravity
elektr@@ oni@@ k	electr@@ on@@ ics
ursprün@@ glich	origin@@ ally
ziehen	pull
persön@@ lichkeit	person@@ ality
wasser@@ stoff	hydro@@ gen
kla@@ vier	piano
beobachten	watch
maga@@ zin	magazine
tradi@@ tionen	tradi@@ tions
blä@@ tter	leaves
blu@@ me	flo@@ wer
vor@@ sichti@@ g	care@@ ful
gleichzeitig	simul@@ tane@@ ously
methoden	metho@@ ds
radik@@ ale	radical
lehr@@ erin	teacher
kranken@@ häuser	hospitals
spielt	plays
demokra@@ tische	democratic
impf@@ stoff	v@@ acc@@ ine
klin@@ ischen	clinical
pl@@ äne	plans
um@@ geben	surro@@ unded
ober@@ flächen	sur@@ faces
wör@@ ter@@ buch	dic@@ tion@@ ary
weib@@ liche	female
erlebt	experienced
schreib@@ tisch	des@@ k
letztendlich	ultimately
beri@@ cht	report
sozusagen	sort
algorith@@ mus	algorith@@ m
elektr@@ ische	electrical
schlag@@ zei@@ len	head@@ lines
erfin@@ der	inv@@ ent@@ or
schla@@ cht	battle
funk@@ tionen	fun@@ ctions
elektron@@ ische	electr@@ onic
sp@@ ani@@ en	spa@@ in
werfen	throw
unabhängi@@ ge	independent
zivili@@ sa@@ tionen	civili@@ zations
neugi@@ er	curi@@ osity
sti@@ ft	pen
an@@ wäl@@ te	law@@ yers
groß@@ eltern	grand@@ parents
ver@@ heirat@@ et	married
kal@@ orien	cal@@ ories
imm@@ uns@@ y@@ stem	imm@@ une
geschlossen	closed
verschmu@@ tzung	pollution
re@@ präsentieren	represent
samm@@ lung	colle@@ ction
zog	moved
kü@@ he	co@@ ws
lang@@ samer	slow
mathemati@@ ker	mathemati@@ cians
heben	raise
schafft	creates
geru@@ ch	smell
dichte	den@@ sity
so@@ w@@ je@@ t@@ union	so@@ vi@@ et
analog@@ ie	analog@@ y
aus@@ nahme	ex@@ ception
unfall	crash
techn@@ ischen	technical
le@@ ktionen	lessons
ursprün@@ gliche	original
6@@ 0ern	6@@ 0s
musi@@ ker	musi@@ cians
vorhersagen	predict
islam@@ ischen	islam@@ ic
um@@ ständen	circum@@ stances
abhängig	depen@@ ding
mathemati@@ schen	mathematical
schla@@ u	smart
billi@@ ger	che@@ aper
zeit@@ ungen	new@@ spa@@ pers
springen	jump
klei@@ dung	clo@@ th@@ es
un@@ gleichheit	ine@@ quality
rätsel	puzz@@ les
beeinflussen	affect
umgehen	deal
defin@@ iert	defined
sei@@ de	silk
gene@@ tisch	gene@@ tically
studi@@ ert	studied
geschle@@ cht	gender
entfern@@ ung	distance
fahr@@ zeug	vehicle
elektro@@ den	electro@@ des
erreicht	reach@@ ed
beob@@ a@@ chtung	obser@@ vation
mär@@ z	mar@@ ch
erlaub@@ nis	per@@ mission
kohlen@@ di@@ ox@@ id	dio@@ xide
de@@ cke	cei@@ ling
zwei@@ fel	dou@@ bt
diagramm	graph
erwä@@ hnen	mention
ver@@ dopp@@ eln	double
sau@@ b@@ ere	clean
durch@@ messer	diam@@ e@@ ter
öko@@ systeme	eco@@ systems
wü@@ tend	an@@ gry
aspe@@ kte	aspe@@ cts
eindruck	impres@@ sion
z@@ elt	tent
dru@@ cken	print
beschrei@@ bung	descri@@ ption
gleich@@ ungen	equ@@ ations
zehn@@ tausende	tens
begren@@ zt	limited
haus@@ aufgaben	home@@ work
schwei@@ zer	s@@ wis@@ s
erhö@@ hen	increase
zei@@ traum	period
schw@@ eine	pig@@ s
d@@ ör@@ fern	villa@@ ges
elektr@@ onen	electr@@ ons
skla@@ ver@@ ei	sla@@ very
lü@@ gen	lie
schä@@ del	sk@@ ul@@ l
rei@@ cher	ri@@ cher
schwan@@ ger	preg@@ nant
r@@ auch	smo@@ ke
musli@@ mischen	musli@@ m
umgeb@@ ungen	environments
selbstverständlich	gran@@ ted
rhyth@@ mus	rhyth@@ m
städ@@ tischen	urban
7@@ 0ern	7@@ 0s
zentr@@ alen	central
gefü@@ llt	filled
ausge@@ bildet	trained
einge@@ führt	introduced
verste@@ cken	hi@@ de
ge@@ messen	measu@@ red
beeinflusst	influ@@ enced
fas@@ ern	fi@@ bers
ab@@ ent@@ euer	ad@@ vent@@ ure
spieler	player
kri@@ tische	critical
prei@@ se	pri@@ ces
auf@@ lösung	resol@@ ution
verkehr	traffic
ka@@ pa@@ zität	capacity
beweis	pro@@ of
über@@ setzt	transl@@ ated
psych@@ ologen	psych@@ ologists
protot@@ y@@ p	prototyp@@ e
jahrhunder@@ te	cent@@ u@@ ries
glücklicherweise	fortunately
re@@ z@@ ession	rec@@ ession
mei@@ le	mile
diszi@@ pli@@ n	discipl@@ ine
ungewöhn@@ lich	unusual
mechan@@ ismus	mechan@@ ism
schu@@ ld	bl@@ ame
an@@ nahmen	assu@@ mp@@ tions
vorstellen	introdu@@ ce
kombin@@ ieren	com@@ bine
un@@ sicherheit	un@@ certain@@ ty
elektr@@ ischen	electric
vergleich	compar@@ ison
berech@@ nen	calcu@@ late
täusch@@ ung	de@@ ception
geschü@@ tzt	prote@@ cted
verdienen	ear@@ n
verbesser@@ ung	impro@@ vement
diagno@@ sti@@ ziert	diagno@@ sed
intellektu@@ ellen	intellectual
liebt	lo@@ ves
schreck@@ liche	terrible
vor@@ schlag	pro@@ pos@@ al
wohn@@ ung	a@@ partment
fahr@@ rad	bi@@ cycle
wissen@@ s	knowledge
auswirkungen	impli@@ cations
erklär@@ te	expla@@ ined
schaf@@ e	she@@ ep
konzentri@@ ert	focused
ök@@ ologie	ec@@ ology
prototyp@@ en	prototyp@@ es
teil@@ weise	par@@ tly
konfli@@ kte	confli@@ cts
franzö@@ sische	french
an@@ wal@@ t	law@@ yer
währ@@ ung	cur@@ ren@@ cy
anwendung	app@@ lic@@ ation
zeichnungen	dra@@ wings
mus@@ kel	muscle
fla@@ ch	flat
unterrichten	teaching
glam@@ our@@ ö@@ s	glam@@ or@@ ous
männ@@ chen	males
japan@@ ischen	japanese
freundin	gir@@ l@@ friend
stehe	standing
belie@@ bt	popular
reak@@ tionen	re@@ actions
schi@@ chten	la@@ yers
schmer@@ z@@ haft	pain@@ ful
läch@@ er@@ lich	ridi@@ cul@@ ous
wert@@ voll	valuable
land@@ schaften	landscap@@ es
kol@@ on@@ ien	col@@ on@@ ies
du@@ mm	stupid
alten	ancient
besor@@ gt	worried
sozi@@ al	so@@ cially
bürger@@ krieg	civil
dra@@ matisch	dra@@ matically
über@@ winden	over@@ come
pan@@ dem@@ ie	pan@@ de@@ mic
9@@ 0ern	9@@ 0s
wa@@ ffe	gun
neuro@@ wissenschaft	neuro@@ science
krei@@ se	cir@@ cles
flüs@@ sigkeit	liquid
treib@@ stoff	fuel
körper@@ n	bodies
lö@@ wen	li@@ ons
tiefe	dep@@ th
noten	notes
krä@@ hen	cro@@ ws
fres@@ sen	eat
kat@@ eg@@ orien	categ@@ ories
mü@@ de	ti@@ red
demo@@ kr@@ aten	demo@@ cr@@ ats
glaubt	belie@@ ves
treib@@ haus@@ g@@ ase	green@@ house
unabhängi@@ gkeit	indepen@@ dence
ebenen	levels
über@@ gang	transition
br@@ ücken	bri@@ d@@ ges
dynam@@ ik	dynamic
organisi@@ ert	organized
ben@@ an@@ nt	named
fangen	catch
heutzutage	no@@ wa@@ days
stir@@ bt	dies
syste@@ matisch	syste@@ matically
roman@@ tische	roman@@ tic
berührt	tou@@ ched
annahme	assu@@ mption
lernt	learning
ver@@ gewal@@ tigt	ra@@ ped
setzen	sit
un@@ fälle	acci@@ dents
mö@@ bel	fur@@ ni@@ ture
finanzi@@ ellen	financial
nähr@@ stoffe	nutri@@ ents
dire@@ ktor	director
fähig	capable
schul@@ dig	gu@@ il@@ ty
typ@@ ischen	typical
aus@@ gaben	spending
proz@@ ent@@ satz	percentage
wahr@@ heiten	tru@@ ths
frei@@ tag	fri@@ day
ver@@ sionen	ver@@ sions
riesigen	giant
kamen	coming
tan@@ zen	dan@@ cing
chri@@ sten	chri@@ sti@@ ans
hallu@@ zin@@ ationen	hallu@@ cin@@ ations
an@@ wei@@ sungen	in@@ struc@@ tions
bleibt	rema@@ ins
schlagen	beat
tenden@@ z	tenden@@ cy
super@@ markt	super@@ market
rennen	race
versagen	failure
durch@@ fall	di@@ arr@@ he@@ a
ange@@ stellten	employees
tro@@ pfen	drop
zusätz@@ liche	extra
organ@@ ische	organic
ge@@ trennt	separ@@ ated
sätze	sent@@ ences
bom@@ ben	bom@@ bs
kün@@ ste	arts
hü@@ hn@@ chen	chicken
gleichheit	equ@@ ality
redu@@ ziert	re@@ duced
schau@@ spieler	actor
schwei@@ z	swi@@ tz@@ er@@ land
fahrer	driver
schein@@ bar	seem@@ ingly
er@@ setzt	re@@ placed
fiel	fell
republi@@ kan@@ er	republi@@ cans
zu@@ stimmen	agree
klas@@ sische	classi@@ c
gesprä@@ che	conver@@ sa@@ tions
neu@@ se@@ eland	ze@@ al@@ and
verteilt	distribu@@ ted
ste@@ hlen	ste@@ al
gebro@@ chen	broken
verbindet	conne@@ cts
philosop@@ h	philosop@@ her
musi@@ kal@@ ische	musical
phy@@ s@@ isch	physi@@ cally
hinder@@ nisse	ob@@ stac@@ les
ein@@ heiten	un@@ its
frem@@ de	stran@@ gers
h@@ ung@@ ri@@ g	hun@@ gry
re@@ präsentiert	represents
einheit	unit
politi@@ sch	poli@@ tically
zu@@ geben	ad@@ mit
na@@ deln	need@@ les
langfri@@ stige	long-term
fru@@ stri@@ ert	fru@@ strated
anzu@@ g	suit
pri@@ ma@@ ten	pri@@ mates
gegründet	fo@@ unded
ver@@ doppelt	dou@@ bled
flü@@ gel	wings
bo@@ s@@ nien	bo@@ s@@ nia
fotografi@@ ert	photograph@@ ed
dire@@ kte	direct
ein@@ stellung	at@@ titude
par@@ tei@@ en	par@@ ties
kranken@@ sch@@ western	nur@@ ses
gewöhn@@ liche	ordinary
kor@@ alle	coral
wissenschaft@@ lich	scienti@@ fically
kolle@@ ktiven	collective
lo@@ hnt	worth
klini@@ ken	clin@@ ics
ju@@ gend	you@@ th
brach	broke
ta@@ schen	po@@ ckets
privat@@ sphäre	priv@@ acy
früh@@ stück	break@@ fast
müll	g@@ arb@@ age
mobili@@ tät	mo@@ bility
drei@@ dimension@@ alen	three-@@ dimensional
sal@@ z	s@@ alt
psych@@ ologische	psych@@ ological
architek@@ ton@@ ische	architec@@ tural
an@@ atom@@ ie	an@@ atom@@ y
ri@@ chter	ju@@ dge
einge@@ bet@@ tet	em@@ bed@@ ded
erkenntnis	insi@@ ght
stam@@ m	tri@@ be
prakti@@ sche	practical
kö@@ pfe	heads
drittel	two-@@ thir@@ ds
offen@@ sicht@@ liche	obvious
hei@@ len	cure
aktu@@ ellen	current
wo@@ chen@@ ende	wee@@ k@@ end
kam@@ bo@@ d@@ sch@@ a	cam@@ bo@@ dia
fo@@ li@@ en	sli@@ des
eigent@@ um	property
steuern	ta@@ xes
vertei@@ digung	defen@@ se
passt	f@@ its
wei@@ zen	whe@@ at
kranken@@ schwester	nur@@ se
männ@@ liche	male
hö@@ hle	ca@@ ve
verfolgen	track
tötet	kill@@ s
erfin@@ dungen	inven@@ tions
deut@@ sche	ger@@ man
erzähl@@ ung	narra@@ tive
erzähl@@ ungen	narra@@ tives
freiwilli@@ gen	volunte@@ ers
blieb	sta@@ yed
führ@@ enden	leading
gele@@ gen@@ heiten	opportunities
sicher@@ er	sa@@ fer
investi@@ ert	invest@@ ed
verhaltens@@ weisen	behaviors
flug@@ zeuge	air@@ planes
mein@@ ungen	opini@@ ons
ban@@ ken	ban@@ ks
glü@@ h@@ bir@@ ne	bul@@ b
flüs@@ se	ri@@ vers
auszu@@ drücken	express
pri@@ or@@ itäten	pri@@ ori@@ ties
glaube	belief
baum@@ wol@@ le	c@@ ot@@ ton
span@@ nung	ten@@ sion
veröffent@@ lichen	publi@@ sh
getroffen	hit
hö@@ hlen	ca@@ ves
evolution@@ ären	evolutionary
über@@ setzung	trans@@ lation
weib@@ chen	fe@@ males
schü@@ tt@@ eln	sha@@ ke
ver@@ liert	lo@@ ses
kat@@ eg@@ or@@ ie	categ@@ ory
ver@@ mäch@@ tnis	leg@@ acy
weih@@ na@@ chten	christ@@ mas
8@@ 0ern	8@@ 0s
ge@@ dichte	po@@ em@@ s
er@@ forschung	exploration
fe@@ hlt	missing
behand@@ lungen	treat@@ ments
liefern	deliver
gemein@@ samen	shared
toler@@ anz	toler@@ ance
ku@@ gel	sphere
mil@@ ch@@ straße	mil@@ ky
un@@ bekannte	un@@ known
spezi@@ fische	specific
erneu@@ er@@ bare	rene@@ w@@ able
ir@@ land	ir@@ eland
grün@@ der	fo@@ under
ver@@ haf@@ tet	ar@@ re@@ sted
ge@@ fangen	caught
sitz	seat
interak@@ tionen	inter@@ actions
selbst@@ mor@@ d	su@@ i@@ cide
identi@@ sch	iden@@ tical
durch@@ bruch	break@@ through
hei@@ raten	mar@@ ry
au@@ st@@ aus@@ ch	exchange
mu@@ ta@@ tionen	mu@@ tations
partner@@ schaft	partner@@ ship
gesam@@ melt	colle@@ cted
symme@@ tri@@ en	symme@@ tries
li@@ b@@ ellen	dra@@ gon@@ flies
wohl@@ tä@@ tigkeit	char@@ ity
geschafft	managed
er@@ fordert	requires
aus@@ nahmen	ex@@ cep@@ tions
min@@ der@@ heit	min@@ ority
ma@@ hl@@ zeit	me@@ al
un@@ erwar@@ tete	un@@ expected
t@@ eller	pla@@ te
sch@@ langen	sna@@ kes
wahr@@ nehmen	percei@@ ve
macher	makers
techn@@ isch	techni@@ cally
sel@@ ten@@ e	rare
su@@ ppe	sou@@ p
mechan@@ ische	mechan@@ ical
glü@@ h@@ bir@@ nen	bul@@ bs
iso@@ liert	isol@@ ated
entwickelten	evolved
beob@@ acht@@ ungen	obser@@ va@@ tions
spiel@@ zeug	to@@ y
geri@@ cht	court
hand@@ gelen@@ k	wr@@ ist
trans@@ for@@ mieren	transform
stü@@ hle	cha@@ irs
aus@@ gesetzt	ex@@ posed
p@@ fa@@ d	path
abhängi@@ gkeit	depen@@ dence
an@@ passen	ada@@ pt
grö@@ n@@ land	green@@ land
wie@@ gt	wei@@ gh@@ s
hil@@ frei@@ ch	hel@@ p@@ ful
vari@@ ationen	vari@@ ations
spielte	playing
tru@@ ppen	tro@@ ops
bru@@ ch@@ teil	fra@@ ction
hon@@ ig	hon@@ ey
hei@@ mat@@ stadt	home@@ town
de@@ pri@@ miert	depres@@ sed
läuft	running
athei@@ sten	athei@@ sts
untersuchen	studying
rus@@ sischen	russi@@ an
finan@@ ziert	fund@@ ed
band@@ breite	band@@ wid@@ th
ausge@@ storben	extin@@ ct
ultra@@ sch@@ all	ul@@ tr@@ as@@ o@@ und
berech@@ nungen	calcu@@ lations
l@@ ein@@ wand	can@@ v@@ as
fr@@ ö@@ sche	fro@@ gs
gefragt	wonder@@ ed
köni@@ grei@@ ch	king@@ dom
ang@@ riff	attack
inse@@ kt	inse@@ ct
herausgefunden	figured
versteht	under@@ stands
gehören	bel@@ ong
th@@ un@@ fisch	tun@@ a
mitarbeiter	staf@@ f
gewä@@ hlt	ele@@ cted
ruf	repu@@ tation
impf@@ stoffe	vac@@ cin@@ es
hält	holding
schul@@ tern	shoul@@ ders
wa@@ sch@@ maschine	was@@ hing
besit@@ zer	ow@@ ner
un@@ end@@ liche	infin@@ ite
ko@@ sm@@ ischen	co@@ s@@ mic
rau@@ chen	smo@@ king
dra@@ ht@@ lose	wir@@ eless
fla@@ schen	bot@@ tles
züge	tra@@ ins
visi@@ onen	visi@@ ons
überqu@@ eren	cross
aktivi@@ sten	activi@@ sts
tre@@ ppe	sta@@ ir@@ case
kam@@ el	cam@@ el
hü@@ fte	hi@@ p
kontrolli@@ ert	contro@@ ls
inti@@ mit@@ ät	inti@@ ma@@ cy
über@@ wachen	monit@@ or
identi@@ fiziert	identi@@ fied
par@@ k@@ platz	par@@ king
gew@@ inn	profit
ökon@@ om	econom@@ ist
trin@@ k@@ wasser	drin@@ king
kom@@ mer@@ zi@@ elle	commercial
wieder@@ holen	repe@@ at
begeg@@ nung	en@@ counter
fotogra@@ fen	photogra@@ pher@@ s
l@@ ücken	g@@ ap@@ s
pil@@ ze	mush@@ rooms
entwerfen	designing
erklär@@ ungen	explan@@ ations
wurz@@ el	ro@@ ot
intensi@@ tät	inten@@ sity
mü@@ n@@ ze	co@@ in
fing@@ ern	fing@@ ers
angeb@@ oten	off@@ ered
erneu@@ er@@ baren	rene@@ w@@ ables
haus@@ halt	hou@@ se@@ hold
nach@@ bar	neighb@@ or
sti@@ ck@@ stoff	ni@@ tro@@ gen
ange@@ passt	adap@@ ted
authenti@@ zität	auth@@ en@@ tic@@ ity
platt@@ formen	plat@@ forms
ein@@ laden	invi@@ te
stör@@ ungen	dis@@ orders
flie@@ ßen	flow
demon@@ stri@@ eren	demon@@ strate
5@@ 0ern	5@@ 0s
ma@@ hl@@ zeiten	me@@ als
bele@@ u@@ chtung	ligh@@ ting
freund@@ schaft	friend@@ ship
histor@@ ischen	histor@@ ical
über@@ zeug@@ ungen	belie@@ fs
tä@@ glichen	daily
ver@@ sagt	failed
visu@@ alisierung	visu@@ alization
gingen	walked
stur@@ m	stor@@ m
be@@ graben	bu@@ ried
handlungen	actions
ge@@ worfen	thro@@ wn
büro@@ s	off@@ ices
syn@@ the@@ tische	syn@@ thetic
all@@ gegenwär@@ tig	u@@ bi@@ qu@@ it@@ ous
absicht	in@@ tent
un@@ klar	un@@ clear
ra@@ ke@@ ten	rock@@ ets
berg@@ stei@@ ger	clim@@ bers
infe@@ ktionen	infe@@ ctions
pfer@@ de	hor@@ ses
schnell@@ ste	fa@@ st@@ est
technolog@@ ische	technologi@@ cal
hö@@ he@@ punkt	peak
akzep@@ tanz	accep@@ tan@@ ce
versch@@ win@@ det	disappe@@ ars
mu@@ seen	muse@@ ums
erweitern	exp@@ and
gramm	gra@@ m
inspiri@@ er@@ end	in@@ spir@@ ing
schöpf@@ ung	creation
tra@@ ge	wearing
dritt@@ ens	thir@@ dly
beein@@ dru@@ ckt	impres@@ sed
krei@@ sl@@ auf	cycle
ge@@ sto@@ hlen	stol@@ en
akzep@@ tiert	accep@@ ted
revol@@ u@@ tionen	revol@@ u@@ tions
nor@@ wegen	nor@@ way
te@@ pp@@ ich	car@@ pet
stati@@ stisch	statisti@@ cally
me@@ tern	meters
kre@@ atur	cre@@ ature
ge@@ for@@ mt	sha@@ ped
sp@@ uren	tra@@ ces
kurze	quick
ang@@ ri@@ ffe	attac@@ ks
ver@@ trag	contra@@ ct
übertragen	trans@@ mit
flie@@ gt	flies
erlaub@@ te	allowed
schw@@ ein	pi@@ g
integri@@ tät	integri@@ ty
winkel	angle
sch@@ lau@@ er	smar@@ ter
regel@@ mäßig	regul@@ arly
ei@@ sen	ir@@ on
schul@@ den	de@@ bt
tem@@ pel	temp@@ le
kan@@ di@@ daten	can@@ di@@ dat@@ es
sich@@ eren	safe
druck@@ er@@ presse	prin@@ ting
blin@@ d@@ heit	blin@@ dness
mess@@ ungen	measu@@ re@@ ments
pro@@ stat@@ ak@@ re@@ bs	pro@@ state
hoffen	hop@@ ing
rück@@ en@@ mark	spin@@ al
lang@@ le@@ bi@@ gkeit	lon@@ ge@@ vi@@ ty
schwa@@ ch	we@@ ak
stoff@@ wechsel	me@@ tab@@ oli@@ s@@ m
journ@@ alismus	journ@@ alism
span@@ isch	span@@ ish
au@@ toren	auth@@ ors
k@@ äf@@ er	be@@ et@@ le
myster@@ ium	myster@@ y
meer@@ wasser	se@@ a@@ water
be@@ vorzu@@ gen	pre@@ fer
aufnahme	recor@@ ding
nahr@@ ungsk@@ ette	chain
weiter@@ gegeben	passed
bedro@@ h@@ ungen	thre@@ ats
ab@@ sichten	inten@@ tions
zeich@@ nung	drawing
spezi@@ alisten	speci@@ alists
verbesser@@ ungen	impro@@ v@@ ements
an@@ sichten	vie@@ ws
br@@ eit	wide
über@@ lebt	survi@@ ved
son@@ n@@ tag	sun@@ day
dra@@ mati@@ sche	dra@@ matic
ök@@ ologischen	e@@ col@@ o@@ gical
lieb@@ sten	favorite
web@@ seiten	web@@ sites
bau@@ steine	blocks
ide@@ ologie	ide@@ ology
fort@@ schritte	advan@@ ces
erstaunliche	ast@@ on@@ ishing
blut@@ gefä@@ ße	ves@@ sel@@ s
hü@@ hn@@ er	chi@@ ck@@ ens
ein@@ la@@ dung	invi@@ tation
biolog@@ isch	bi@@ ologi@@ cally
sogenan@@ nten	so-@@ called
program@@ mier@@ er	progra@@ mm@@ ers
skep@@ tisch	skep@@ tical
verhältnis	ra@@ ti@@ o
dä@@ ne@@ mark	den@@ mark
gel@@ eg@@ entlich	occasi@@ on@@ ally
rie@@ cht	sm@@ ells
über@@ tra@@ gung	trans@@ mission
verbessert	impro@@ ved
beinhaltet	invol@@ ves
völ@@ ker	peop@@ les
skulp@@ turen	sculp@@ tures
viel@@ zahl	variety
konzent@@ ration	concent@@ ration
verletz@@ ung	in@@ j@@ ury
nan@@ ot@@ echn@@ ologie	nan@@ ot@@ echn@@ ology
qu@@ anten@@ mechan@@ ik	mechan@@ ics
perspe@@ ktiven	perspe@@ c@@ tives
spiel@@ zeuge	to@@ ys
erwachsene	adult
sch@@ welle	th@@ res@@ hold
wär@@ mer	war@@ mer
grund@@ schule	element@@ ary
sü@@ dlichen	southern
schnitt	cut
klas@@ sischen	classi@@ cal
belo@@ hn@@ ungen	re@@ wards
198@@ 0ern	198@@ 0s
schä@@ tzung	esti@@ mate
arab@@ isch	arab@@ ic
diskus@@ sionen	discus@@ sions
ge@@ du@@ ld	pati@@ ence
überprü@@ fen	check
ne@@ tze	nets
an@@ erken@@ nung	recogni@@ tion
b@@ ären	be@@ ars
proto@@ zelle	proto@@ cell
a@@ ßen	ate
infe@@ ktion	infe@@ ction
zufällig	random
ern@@ ten	harv@@ est
hoch@@ zeit	we@@ d@@ ding
verti@@ k@@ ale	ver@@ tical
ir@@ on@@ is@@ cher@@ weise	ir@@ on@@ ically
hil@@ flo@@ s	hel@@ pl@@ ess
finan@@ zieren	fund
spreche	speak
auf@@ gehört	stopped
beglei@@ tet	ac@@ comp@@ ani@@ ed
schlägt	suggests
gi@@ p@@ fel	sum@@ mit
pil@@ z	mush@@ room
angesehen	considered
pe@@ sti@@ zi@@ de	pe@@ sti@@ ci@@ des
ver@@ gewal@@ tigung	ra@@ pe
ins@@ gesam@@ t	total
merk@@ male	fe@@ atures
drei@@ e@@ ck	tri@@ angle
vorher@@ igen	previous
ab@@ ends	ev@@ ening
konz@@ ert	conc@@ ert
therap@@ ien	therap@@ ies
interak@@ tive	inter@@ active
fossi@@ li@@ en	fossi@@ ls
los@@ werden	rid
zu@@ grunde	under@@ lying
ein@@ führung	introdu@@ ction
verwir@@ rt	conf@@ used
wür@@ fel	cu@@ be
flexi@@ bili@@ tät	flexi@@ bility
bestimmt	determin@@ es
auf@@ zeichnungen	recor@@ ds
über@@ wäl@@ tigt	over@@ wh@@ el@@ med
nehme	suppose
durchgeführt	condu@@ cted
produ@@ ktiv	productive
üb@@ ung	exercise
rahmen	frame
kri@@ teri@@ en	cri@@ teri@@ a
betr@@ ü@@ gen	che@@ at
ge@@ wachsen	grown
herunter@@ laden	down@@ load
hoff@@ nungen	hop@@ es
wohn@@ ungen	a@@ part@@ ments
ge@@ gessen	e@@ aten
attra@@ ktiv	attra@@ ctive
seltsam	weird
rö@@ hre	tube
moral@@ isch	mor@@ ally
psych@@ ologe	psych@@ ologist
existi@@ erte	exi@@ sted
tur@@ m	to@@ wer
aufge@@ zeichnet	recor@@ ded
dru@@ cker	prin@@ ter
vermitteln	con@@ vey
gal@@ er@@ ien	g@@ aller@@ ies
schn@@ elle	fast
schrift@@ steller	writer
lau@@ ter	lou@@ der
diszi@@ pl@@ inen	discipl@@ ines
ägyp@@ ter	eg@@ yp@@ ti@@ ans
anti@@ körper	anti@@ bodies
behinder@@ ung	dis@@ ability
la@@ dung	charge
frem@@ den	stran@@ ger
ersta@@ unt	ama@@ zed
vor@@ der@@ grund	fore@@ ground
lebens	lifetime
ursprün@@ ge	orig@@ ins
histor@@ isch	histor@@ ically
stir@@ n	fore@@ head
un@@ endlich	infin@@ itely
ge@@ fan@@ genen	pris@@ on@@ ers
an@@ streng@@ ung	effort
ku@@ chen	ca@@ ke
selbst@@ vertrauen	confidence
bei@@ trag	contribu@@ tion
künstler@@ ischen	arti@@ stic
eth@@ ische	eth@@ ical
gesundheitswesen	healthcare
kar@@ to@@ ff@@ eln	po@@ tat@@ o@@ es
un@@ gerechtigkeit	in@@ justice
schie@@ ßen	sho@@ ot
bau@@ er	farmer
mis@@ chung	mix@@ ture
mit@@ leid	p@@ ity
schreibt	wri@@ tes
einfach@@ ste	simpl@@ est
partner@@ schaften	partner@@ ships
teil@@ chen@@ physik	partic@@ le
vorher@@ sage	predi@@ ction
wün@@ sche	wi@@ sh@@ es
schei@@ ße	sh@@ it
ruhi@@ g	quie@@ t
er@@ hielt	received
hinder@@ nis	ob@@ stac@@ le
mü@@ cken	mo@@ squ@@ it@@ os
heili@@ ge	hol@@ y
be@@ ute	pre@@ y
sie@@ g	vic@@ tory
verur@@ teilt	con@@ vi@@ cted
sch@@ alter	switch
satelli@@ ten	satelli@@ tes
stärken	streng@@ ths
not@@ aufnahme	emergen@@ cy
mü@@ cke	mo@@ s@@ qui@@ to
eth@@ n@@ ische	eth@@ ni@@ c
begeistert	thri@@ ll@@ ed
entwickl@@ ungen	develop@@ ments
physi@@ ologie	physi@@ ology
po@@ len	po@@ land
amin@@ o@@ sä@@ uren	amin@@ o
bau@@ ch@@ spei@@ ch@@ el@@ drü@@ sen@@ krebs	pan@@ crea@@ tic
däch@@ er	roo@@ fs
berech@@ nung	compu@@ tation
unterschei@@ dung	distin@@ ction
frü@@ her@@ ken@@ nung	dete@@ ction
sch@@ ad@@ stoffe	pollu@@ tan@@ ts
doku@@ men@@ tieren	docum@@ ent
identi@@ täten	identi@@ ties
schwan@@ ger@@ schaft	preg@@ nan@@ cy
gewinn@@ t	w@@ ins
institu@@ tion@@ elle	institu@@ tional
ko@@ sm@@ ologie	co@@ sm@@ ology
archi@@ v	archi@@ ve
lebens@@ stil	lifest@@ yle
schrecklich	awful
vertei@@ digen	de@@ f@@ end
teil@@ nehmen	participa@@ te
scho@@ ck@@ iert	sho@@ cked
ge@@ teilt	divi@@ ded
emp@@ fehlen	re@@ com@@ men@@ d
bemü@@ h@@ ungen	eff@@ or@@ ts
be@@ decken	cover
bei@@ tragen	contribu@@ te
lehr@@ plan	cur@@ ri@@ cul@@ um
verzwei@@ felt	des@@ per@@ ately
kari@@ bi@@ k	car@@ ib@@ be@@ an
197@@ 0ern	197@@ 0s
versu@@ chung	temp@@ tation
schü@@ chtern	sh@@ y
versch@@ wand	disappe@@ ared
lun@@ gen@@ ent@@ z@@ ün@@ dung	p@@ ne@@ um@@ on@@ ia
produ@@ z@@ enten	produ@@ cers
proje@@ ktion	proje@@ ction
stimmung	mo@@ od
grundle@@ gend	fundament@@ ally
ausge@@ zeichnet	exc@@ ell@@ ent
kombin@@ iert	combin@@ ed
pri@@ or@@ ität	pri@@ ority
pu@@ ber@@ tät	pu@@ ber@@ ty
lau@@ t@@ sprecher	speak@@ er
be@@ frei@@ ung	liber@@ ation
astron@@ au@@ ten	astron@@ au@@ ts
ge@@ star@@ tet	launched
verletz@@ lich	vulnerable
strateg@@ ische	strate@@ gic
hell	bright
kle@@ ttern	clim@@ b
industri@@ en	industri@@ es
unter@@ schätzen	under@@ esti@@ mate
unterstützt	suppor@@ ted
re@@ zep@@ tor	re@@ cep@@ tor
repli@@ zieren	repli@@ cate
mal@@ er	pain@@ ter
kno@@ chen@@ mark	mar@@ row
kon@@ ne@@ k@@ tivität	connec@@ tivity
flü@@ cht@@ linge	re@@ fu@@ ge@@ es
ein@@ nahmen	re@@ venue
wähl@@ er	vot@@ ers
flu@@ ktu@@ ationen	flu@@ c@@ tu@@ ations
er@@ scho@@ ssen	shot
flu@@ gh@@ ä@@ fen	air@@ por@@ ts
kinder@@ si@@ tze	se@@ ats
leiter	la@@ d@@ der
ge@@ hö@@ r	hearing
neu	rein@@ vent@@ ing
besu@@ cht	vis@@ ited
ver@@ arbei@@ tung	process@@ ing
arbeits@@ lo@@ sigkeit	un@@ emplo@@ y@@ ment
fuhr	dro@@ ve
abschluss	degree
beri@@ chte	repor@@ ts
ras@@ s@@ ismus	ra@@ c@@ ism
konfer@@ en@@ zen	con@@ fer@@ ences
bereich	do@@ main
mo@@ sche@@ e	mo@@ squ@@ e
groß@@ zü@@ gi@@ gkeit	gener@@ osity
tu@@ gend	virtu@@ e
hand@@ voll	hand@@ ful
g@@ let@@ scher	gl@@ aci@@ ers
3@@ 0@@ 0.000	3@@ 0@@ 0,000
zwei@@ g	bran@@ ch
über@@ denken	re@@ think
ange@@ trieben	driven
umgebung	surro@@ und@@ ings
zer@@ brech@@ lich	fra@@ gi@@ le
schalt@@ kreis	circu@@ it
all@@ tag	everyday
beeindruck@@ end	impres@@ sive
natur@@ schutz	conser@@ vation
ir@@ anischen	ir@@ ani@@ an
an@@ wes@@ enheit	pres@@ ence
konfron@@ tiert	con@@ fron@@ ted
schla@@ gan@@ fall	stro@@ ke
migr@@ äne	migra@@ ine
kri@@ tiker	cri@@ tic
mensch@@ heits@@ geschichte	history
verletz@@ ungen	in@@ ju@@ ries
haus@@ halte	hou@@ se@@ hol@@ ds
cyber@@ krimin@@ ellen	cyber@@ crimin@@ als
ge@@ e@@ hrt	hon@@ or@@ ed
kultur@@ ell	cul@@ tur@@ ally
aus@@ län@@ dische	foreign
nigeri@@ anischen	nigeri@@ an
er@@ schw@@ ing@@ lich	aff@@ ord@@ able
vorberei@@ tung	prepar@@ ation
besteht	consi@@ sts
e@@ cken	cor@@ ners
199@@ 0ern	199@@ 0s
ver@@ letzt	hurt
ge@@ plant	plan@@ ned
zeit@@ gen@@ ö@@ ss@@ ische	con@@ temporary
aus@@ sterben	extin@@ ction
qu@@ al@@ itäten	quali@@ ties
sen@@ det	sen@@ ds
gefahren	dan@@ gers
benutz@@ er	user
fis@@ cher	fis@@ her@@ men
ak@@ a@@ dem@@ ischen	acade@@ mic
bogen	bo@@ w
ä@@ qui@@ valent	equivalent
be@@ wohner	resi@@ dents
kontrolli@@ erte	controlled
erscheint	appe@@ ars
195@@ 0ern	195@@ 0s
ehe@@ frau	wife
klar@@ heit	c@@ lar@@ ity
prin@@ z	prin@@ ce
wie@@ gen	wei@@ gh
wahl@@ möglichkeiten	choices
redu@@ ktion	redu@@ ction
offi@@ zi@@ ellen	offi@@ cial
sch@@ ot@@ t@@ land	scot@@ land
leiden@@ schaften	passi@@ ons
aufnahmen	foot@@ age
behör@@ den	auth@@ ori@@ ties
verfügung	provide
zieht	pul@@ ls
ta@@ ges@@ licht	da@@ y@@ light
wirtschaft@@ lich	econom@@ ically
ver@@ handlungen	negoti@@ ations
ökonom@@ ie	economics
christ@@ us	chr@@ ist
ab@@ gele@@ genen	remote
instal@@ la@@ tionen	instal@@ lations
ur@@ lau@@ b	vac@@ ation
motivi@@ ert	motiv@@ ated
ver@@ lu@@ ste	los@@ ses
korre@@ kt	cor@@ rect
jähr@@ liche	an@@ nu@@ al
sam@@ stag	satur@@ day
erweiter@@ ung	exten@@ sion
typ@@ is@@ cher@@ weise	typically
rela@@ tivi@@ tä@@ ts@@ theorie	rela@@ tivity
zu@@ fall	co@@ inci@@ dence
well@@ en@@ län@@ ge	wa@@ vel@@ ength
dar@@ stellung	repres@@ entation
anima@@ tionen	anima@@ tions
bi@@ ologe	biolog@@ ist
ko@@ oper@@ ieren	co@@ operate
arbeitsp@@ l@@ atz	work@@ place
behaup@@ ten	cla@@ im
human@@ it@@ ären	human@@ it@@ arian
nieder@@ landen	ne@@ ther@@ lands
histor@@ i@@ ker	histor@@ ian
beobachtet	watching
fr@@ ische	fresh
land@@ wirtschaftlichen	agri@@ cultural
ä@@ p@@ fel	ap@@ ples
ab@@ wes@@ enheit	ab@@ sen@@ ce
recht@@ fer@@ tigen	justi@@ fy
verwand@@ ten	rela@@ tives
ge@@ be@@ te	pra@@ yers
philosoph@@ ische	philosop@@ hi@@ cal
flie@@ ßt	flo@@ ws
reich@@ sten	rich@@ est
domin@@ iert	domin@@ ated
transpor@@ tiert	transpor@@ ted
ver@@ bran@@ nt	bur@@ ned
hand@@ fläche	pal@@ m
zä@@ hlt	coun@@ ts
be@@ zieht	re@@ f@@ ers
fotografi@@ en	photographs
n@@ ör@@ dlichen	northern
sch@@ lange	sna@@ ke
stör@@ ung	dis@@ order
krei@@ de	ch@@ al@@ k
gespro@@ ch@@ ene	spo@@ ken
ak@@ ade@@ mi@@ ker	acade@@ mi@@ cs
kari@@ kat@@ ur	carto@@ on
ob@@ da@@ ch@@ losen	hom@@ eless
öff@@ entlich	publi@@ c@@ ly
treibt	dri@@ ves
mor@@ d	mur@@ der
visu@@ ell	visu@@ ally
trauri@@ gkeit	sa@@ dness
erkenn@@ tnisse	insi@@ ghts
unabhängig	indepen@@ d@@ ently
verfüg@@ barkeit	avail@@ ability
schä@@ tz@@ ungen	esti@@ mates
statisti@@ k	stati@@ stic
finanzi@@ erung	fund@@ ing
ge@@ zä@@ hlt	coun@@ ted
persön@@ lichkeiten	person@@ ali@@ ties
pfei@@ le	ar@@ ro@@ ws
kol@@ li@@ sion	colli@@ sion
ein@@ stellungen	at@@ ti@@ tu@@ des
flie@@ gende	flying
bau	construction
kapit@@ ä@@ n	cap@@ tain
gra@@ b	gra@@ ve
nä@@ chte	ni@@ ghts
be@@ trie@@ bs@@ system	operating
rhyth@@ men	rhyth@@ ms
präsi@@ denten	presi@@ dents
lam@@ pe	lam@@ p
wa@@ schen	was@@ h
mittel@@ alter	ages
gewissen	con@@ science
todes@@ stra@@ fe	pen@@ al@@ ty
schlei@@ fe	loo@@ p
köni@@ ge	k@@ ings
baut	buil@@ ds
sch@@ ale	dis@@ h
ver@@ li@@ erer	lo@@ ser
papi@@ ere	pa@@ pers
posi@@ tionen	posi@@ tions
dien@@ stag	tu@@ es@@ day
pri@@ m@@ zahl	prime
schi@@ ffen	ships
hig@@ g@@ s-@@ teilchen	hig@@ gs
jahr@@ es@@ zeiten	seas@@ ons
voraus@@ sagen	predic@@ tions
sen@@ f	mu@@ star@@ d
la@@ dungen	char@@ ges
ur@@ he@@ ber@@ recht	copy@@ right
nor@@ den-@@ bom@@ ben@@ ziel@@ gerät	bom@@ b@@ sight
wa@@ ch	a@@ wake
er@@ for@@ dern	require
phili@@ pp@@ inen	phili@@ pp@@ ines
drücken	push
gen@@ es@@ ung	re@@ co@@ very
leuten	folks
ver@@ geb@@ ung	for@@ gi@@ ven@@ ess
gü@@ te	kin@@ dness
ka@@ tho@@ li@@ schen	ca@@ tho@@ lic
uns@@ inn	non@@ sense
ge@@ fr@@ oren	fro@@ zen
bibliothe@@ ken	libr@@ aries
scan@@ nen	scan
belo@@ hnt	re@@ war@@ ded
ahnung	clu@@ e
voll@@ stän@@ dige	complete
ver@@ schreiben	pres@@ cri@@ be
niedri@@ gsten	lo@@ west
spr@@ ingt	jum@@ ps
pfei@@ fen	whi@@ st@@ le
zehn@@ tel	tent@@ h
raum@@ zeit	spac@@ e-@@ time
gewal@@ tt@@ ä@@ tig	violent
tren@@ nung	separ@@ ation
bes@@ essen@@ heit	obs@@ ession
aktivi@@ ert	activ@@ ated
ange@@ gri@@ ffen	attac@@ ked
instal@@ liert	inst@@ all@@ ed
du@@ sche	sho@@ wer
offi@@ zi@@ ell	offi@@ cially
kür@@ zer	shor@@ ter
ein@@ richtung	facili@@ ty
drei@@ ecke	tri@@ an@@ gles
multi@@ pli@@ zieren	multi@@ p@@ ly
be@@ steh@@ ende	exi@@ sting
wil@@ dnis	wil@@ der@@ ness
heili@@ gen	sac@@ red
senden	sending
dom@@ inier@@ ende	domin@@ ant
beri@@ chtet	repor@@ ted
ak@@ z@@ ent	ac@@ cent
analy@@ siert	analy@@ zed
wo@@ chen@@ enden	wee@@ ken@@ ds
stelle	spot
del@@ f@@ in	dolph@@ in
gesp@@ ei@@ ch@@ ert	stor@@ ed
stand@@ ort	location
sitzt	si@@ ts
hört	he@@ ars
spiel@@ platz	play@@ ground
spek@@ ta@@ kul@@ äre	spec@@ tac@@ ular
den@@ ker	thin@@ kers
histor@@ ische	histor@@ ic
trug	wor@@ e
op@@ tische	op@@ tical
gelan@@ det	land@@ ed
leiden@@ schaft@@ lichen	passionate
beru@@ hi@@ gen	cal@@ m
beobach@@ ter	obser@@ ver
ur@@ teil	jud@@ gment
hörte	listen@@ ed
erkannt	recogni@@ zed
ge@@ bildet	educ@@ ated
kauft	bu@@ ys
erzeugt	gener@@ ates
weiter@@ geben	pass
fig@@ uren	fig@@ ures
caf@@ é	caf@@ e
bei@@ ge@@ tragen	contribu@@ ted
lö@@ schen	d@@ ele@@ te
sexu@@ alität	sexu@@ ality
war@@ nung	war@@ ning
über@@ wach@@ ung	sur@@ v@@ ei@@ llan@@ ce
wissenschaft@@ ler@@ in	scientist
wider@@ stehen	res@@ ist
mechan@@ isch	mechan@@ ically
schrift	writing
fil@@ me@@ macher	film@@ maker
baum@@ kr@@ onen	can@@ op@@ y
chemi@@ ker	chem@@ ist
hei@@ ß@@ er	hot@@ ter
ha@@ fen	h@@ arb@@ or
schn@@ ur@@ r@@ bart	mu@@ sta@@ che
ver@@ fassung	const@@ it@@ ution
daten@@ ban@@ ken	dat@@ ab@@ ases
ja@@ h@@ re@@ stag	an@@ ni@@ ver@@ s@@ ary
wander@@ tau@@ be	pi@@ ge@@ on
tu@@ ber@@ ku@@ lose	tu@@ ber@@ cu@@ los@@ is
qu@@ anten@@ theorie	quant@@ um
deser@@ ti@@ fi@@ kation	deser@@ ti@@ fication
chron@@ ischen	chr@@ onic
mul@@ tin@@ a@@ tion@@ alen	mul@@ tin@@ a@@ tional
verbreitung	pre@@ val@@ ence
krimin@@ elle	crimin@@ als
son@@ de	probe
an@@ äs@@ thes@@ ie	an@@ es@@ thes@@ ia
pho@@ en@@ i@@ x@@ inseln	pho@@ en@@ i@@ x
wohn@@ wagen	tra@@ il@@ er
ver@@ ben	ver@@ bs
groß@@ zü@@ gi@@ g	gener@@ ous
sti@@ ft@@ ungen	foun@@ da@@ tions
gefäng@@ nisse	pris@@ ons
genauso	equ@@ ally
er@@ schö@@ pft	ex@@ hau@@ sted
ge@@ halt	sal@@ ary
fin@@ n@@ land	fin@@ land
athei@@ s@@ mus	athei@@ s@@ m
be@@ w@@ un@@ dern	ad@@ mi@@ re
hinter@@ h@@ of	back@@ y@@ ard
strat@@ o@@ sphäre	strat@@ o@@ sphere
ge@@ trei@@ de	grain
raum@@ station	station
ent@@ wal@@ dung	de@@ for@@ est@@ ation
an@@ zeichen	sig@@ ns
er@@ holen	re@@ cover
aus@@ rede	exc@@ use
be@@ än@@ g@@ sti@@ gend	sc@@ ary
stand@@ punkt	stand@@ point
anthropo@@ lo@@ gen	anthropo@@ logi@@ sts
mit@@ fühl@@ end	com@@ passionate
erfü@@ llen	ful@@ fill
fort@@ gesch@@ ri@@ tt@@ ene	advanced
tin@@ ten@@ fisch	squ@@ id
wieder@@ holt	repe@@ at@@ ed@@ ly
mathemati@@ sch	mathema@@ tically
stati@@ stische	statisti@@ cal
beding@@ ung	condition
verk@@ auf	s@@ ale
verpflich@@ tung	commit@@ ment
klin@@ isch	clin@@ ically
he@@ mis@@ ph@@ äre	he@@ mis@@ ph@@ ere
be@@ antwor@@ tet	ans@@ wer@@ ed
is@@ st	e@@ ats
hinter@@ lassen	leaving
hö@@ chst	highly
ein@@ stellen	hi@@ re
einrichtungen	facili@@ ties
wider@@ stand@@ s@@ fähigkeit	resili@@ ence
ell@@ en@@ bogen	el@@ bo@@ w
be@@ er@@ digung	fun@@ er@@ al
ver@@ geben	for@@ give
ehen	marri@@ ages
zu@@ frieden	satis@@ fied
wel@@ tan@@ schau@@ ung	world@@ view
li@@ z@@ enz	licen@@ se
kl@@ at@@ schen	cla@@ pping
sub@@ ven@@ tionen	sub@@ si@@ dies
al@@ b@@ traum	ni@@ ght@@ m@@ are
außen@@ politik	policy
um@@ gewand@@ elt	trans@@ formed
bin@@ dung	atta@@ ch@@ ment
jung@@ frau	virg@@ in
be@@ wiesen	pro@@ ven
abstra@@ ktion	abstra@@ ction
ver@@ passt	mis@@ sed
finanzi@@ ell	finan@@ cially
ver@@ handeln	negoti@@ ate
vor@@ lieben	pre@@ fer@@ ences
schöpf@@ er	cre@@ ator
schlag@@ zei@@ le	head@@ line
program@@ miert	progra@@ mm@@ ed
rück@@ gang	dec@@ line
unterscheiden	dist@@ ingu@@ ish
an@@ ste@@ ck@@ end	con@@ ta@@ gi@@ ous
reali@@ stisch	reali@@ stic
tief@@ greif@@ ende	profound
elektro@@ magne@@ tische	electro@@ magnetic
ka@@ ch@@ eln	ti@@ les
enzy@@ m	enzy@@ me
g@@ rie@@ ch@@ ischen	gre@@ ek
techn@@ ologen	technologi@@ sts
rechen@@ leistung	computing
syste@@ mati@@ sche	syste@@ matic
mo@@ sk@@ au	mo@@ s@@ co@@ w
ab@@ wei@@ chung	diver@@ gen@@ ce
christ@@ liche	chri@@ stian
nachbar@@ schaften	neighbor@@ ho@@ ods
kle@@ ber	gl@@ ue
wel@@ tre@@ kor@@ d	record
sei@@ fe	so@@ ap
zahn@@ arzt	den@@ ti@@ st
gemein@@ nütz@@ ige	non@@ profit
si@@ tzung	s@@ ession
ver@@ sich@@ erung	in@@ sur@@ ance
verein@@ bar@@ ung	agre@@ ement
doku@@ men@@ tiert	docum@@ ented
ö@@ ster@@ reich	au@@ stri@@ a
spr@@ ung	lea@@ p
ange@@ wen@@ det	applied
versch@@ wör@@ ung	con@@ spi@@ ra@@ cy
gesi@@ chts@@ aus@@ drü@@ cke	fac@@ ial
dynam@@ isch	dynam@@ ically
erwar@@ tung	expec@@ tation
3@@ 0er	3@@ 0s
ru@@ pi@@ en	ru@@ pe@@ es
authenti@@ sch	authenti@@ c
schwarz@@ äu@@ gi@@ ge	black@@ -@@ e@@ yed
be@@ wahren	preser@@ ve
verur@@ sachen	caus@@ ing
me@@ hl	fl@@ our
neuro@@ wissenschaftler	neuro@@ scientists
man@@ gel@@ ernährung	mal@@ nutri@@ tion
homo@@ sexu@@ alität	homo@@ sexu@@ ality
program@@ mieren	progra@@ mming
bun@@ des@@ regierung	fe@@ der@@ al
indi@@ re@@ kt	indi@@ rec@@ tly
nie@@ dlich	c@@ ute
k@@ noten	no@@ des
kompli@@ ka@@ tionen	compli@@ cations
frü@@ chte	fru@@ its
merk@@ mal	fe@@ ature
itali@@ en@@ ische	itali@@ an
er@@ schien	appe@@ ared
techni@@ ker	techni@@ cian
menschen@@ menge	crowd
anpas@@ sung	adap@@ tation
kri@@ tik	cri@@ tic@@ ism
ent@@ kommen	es@@ cape
ver@@ bot@@ en	ban@@ ned
äl@@ ter@@ er	el@@ der@@ ly
integri@@ ert	integr@@ ated
obje@@ ktive	obje@@ ctive
gesch@@ wi@@ ster	si@@ bl@@ ings
fuß@@ ab@@ druck	foot@@ print
rett@@ ung	res@@ cu@@ e
bedeu@@ tungen	mean@@ ings
gei@@ ge	vi@@ o@@ lin
verwal@@ ten	manage
ver@@ lang@@ sam@@ t	slo@@ wed
un@@ sicher	inse@@ cure
aussehen	appe@@ ar@@ ance
ausge@@ wä@@ hlt	cho@@ sen
umge@@ kehr@@ te	rever@@ se
mitt@@ wo@@ ch	we@@ dn@@ es@@ day
ma@@ gi@@ er	ma@@ gi@@ cian
wei@@ che	soft
konstru@@ iert	constru@@ cted
ank@@ am	arrived
un@@ fähig	un@@ able
beschle@@ un@@ ig@@ ung	acceler@@ ation
erfol@@ ge	success@@ es
se@@ ktoren	sec@@ tors
plö@@ tz@@ lichen	sudden
ver@@ spro@@ chen	promis@@ ed
herstellung	manufacturing
kontin@@ u@@ ität	continu@@ ity
kümm@@ ert	car@@ es
fischen	fishing
wichtige	major
tauchen	di@@ ving
hoff@@ nungs@@ los	hop@@ eless
magne@@ tische	magnetic
ein@@ spar@@ ungen	sav@@ ings
schw@@ ell@@ en@@ ländern	emerging
schl@@ am@@ m	mu@@ d
er@@ zogen	raised
betr@@ un@@ ken	dr@@ un@@ k
antwor@@ tete	repli@@ ed
lei@@ hen	bor@@ row
besch@@ weren	com@@ pla@@ in
sta@@ tisch	sta@@ tic
verb@@ ün@@ dete	al@@ lies
besch@@ ä@@ digt	dama@@ ged
ge@@ tragen	car@@ ried
haltung	post@@ ure
un@@ vermei@@ dlich	inevi@@ table
entfern@@ ungen	di@@ stances
epi@@ le@@ p@@ sie	epi@@ le@@ p@@ sy
raum@@ schiff	spac@@ es@@ hi@@ p
ge@@ ologen	ge@@ ologists
aufzu@@ g	el@@ ev@@ ator
ly@@ m@@ ph@@ k@@ noten	ly@@ mp@@ h
mü@@ n@@ zen	co@@ ins
unterneh@@ mer@@ t@@ um	entreprene@@ ur@@ ship
besu@@ cher	vis@@ it@@ ors
geschi@@ chten@@ erzähl@@ er	story@@ t@@ eller
rin@@ d@@ fleisch	bee@@ f
wahr@@ genommen	percei@@ ved
zwe@@ cke	pur@@ pos@@ es
transpor@@ tieren	transport
glück@@ lichsten	happ@@ i@@ est
interven@@ tionen	interven@@ tions
sequen@@ ziert	sequen@@ ced
nenne	calling
ein@@ schrän@@ kung	limit@@ ation
vari@@ abili@@ tät	vari@@ ability
schlu@@ g	pro@@ posed
umzu@@ gehen	dealing
be@@ gehen	com@@ mit
mis@@ st	meas@@ ures
diagno@@ sti@@ zieren	diagno@@ se
schließen	conclu@@ de
angeneh@@ me	pleas@@ ant
ide@@ alismus	ide@@ alism
spiel@@ ern	players
abhän@@ gen	dep@@ end
techn@@ ische	engineering
kon@@ ven@@ tion@@ elle	conven@@ tional
ver@@ gleich@@ bar	compar@@ able
aus@@ bruch	out@@ break
europä@@ er	europe@@ ans
komm@@ un@@ ismus	commun@@ ism
erhö@@ ht	incre@@ ases
wün@@ schte	wi@@ shed
oli@@ ven@@ öl	o@@ live
ur@@ in	ur@@ ine
ge@@ stimmt	vot@@ ed
miss@@ brauch	ab@@ use
meister	master
über@@ lebenden	survi@@ vor@@ s
schmu@@ ck	je@@ wel@@ ry
di@@ k@@ tat@@ oren	dic@@ tat@@ ors
pro@@ vin@@ z	pro@@ vin@@ ce
op@@ fern	sac@@ ri@@ fi@@ ce
mag@@ ische	ma@@ gical
fische	fis@@ hes
um@@ fragen	sur@@ ve@@ ys
fuß@@ ball	foot@@ ball
geschi@@ chten@@ erzähl@@ ens	story@@ telling
pf@@ eil	ar@@ row
tas@@ man@@ ischen	tas@@ mani@@ an
ju@@ dent@@ um	ju@@ da@@ ism
zeit@@ schriften	maga@@ zin@@ es
gemein@@ kosten	over@@ head
se@@ ele@@ op@@ ar@@ den	le@@ op@@ ard
schi@@ enen	tra@@ cks
er@@ fassung	cen@@ su@@ s
riesen@@ ha@@ ie	bas@@ king
kan@@ ä@@ le	chan@@ n@@ els
wert@@ schä@@ tzung	appreci@@ ation
umwelt@@ probleme	environmental
bild@@ hau@@ er	sculp@@ tor
ver@@ körper@@ ung	em@@ bo@@ di@@ ment
ermu@@ tigt	encoura@@ ged
bestä@@ tigen	con@@ fir@@ m
trag@@ isch	tra@@ gic
wi@@ ese	me@@ a@@ dow
zeich@@ nete	dre@@ w
sch@@ ne@@ cken	sna@@ ils
faszinier@@ ende	intri@@ gu@@ ing
fas@@ sa@@ de	fac@@ ade
wasser@@ fall	water@@ fall
aus@@ gelö@@ scht	wi@@ ped
äuß@@ ere	ou@@ ter
erkennt	recogni@@ zes
vor@@ les@@ ungen	lec@@ tures
kom@@ pe@@ ten@@ z	compe@@ ten@@ ce
be@@ stra@@ fen	pun@@ ish
vorher@@ gesagt	predi@@ cted
zusammenhang	cor@@ relation
er@@ mor@@ det	mur@@ dered
auf@@ trag	as@@ sign@@ ment
bet@@ onen	em@@ ph@@ asi@@ ze
land@@ ung	land@@ ing
prakti@@ ken	practic@@ es
außer@@ ord@@ entlich	extra@@ ordin@@ arily
lebens@@ mittel	fo@@ ods
proble@@ matisch	proble@@ matic
za@@ hn	to@@ oth
be@@ waff@@ neten	ar@@ med
ba@@ de@@ zimmer	ba@@ th@@ room
ar@@ teri@@ en	ar@@ ter@@ ies
regu@@ li@@ erung	regu@@ lation
über@@ fis@@ chung	over@@ fishing
has@@ ste	hat@@ ed
fort@@ setzung	sequ@@ el
entsch@@ lossen	determin@@ ed
untersuchung	investi@@ gation
pro@@ -@@ kop@@ f-@@ einkommen	capit@@ a
auto@@ unfall	accident
poli@@ zi@@ sten	poli@@ ce@@ men
sucht	addi@@ ction
kombin@@ ationen	combin@@ ations
rei@@ bung	fri@@ ction
richt@@ linien	poli@@ cies
zahn@@ bür@@ ste	to@@ o@@ th@@ br@@ ush
phän@@ omen@@ ale	phenomen@@ al
ver@@ spricht	promis@@ es
krimin@@ ellen	crimin@@ al
be@@ treten	enter
unter@@ sch@@ rieben	sig@@ ned
tro@@ p@@ ischen	tro@@ pic@@ al
wohl@@ hab@@ enden	weal@@ thy
isra@@ eli@@ sche	isra@@ el@@ i
flü@@ cht@@ l@@ ing@@ sla@@ ger	re@@ fu@@ ge@@ e
nutz@@ pflanzen	cro@@ ps
dar@@ gestellt	repres@@ ented
schwä@@ che	we@@ ak@@ ness
geschä@@ tzt	esti@@ ma@@ ted
ent@@ span@@ nen	rela@@ x
vor@@ schlä@@ ge	sugge@@ sti@@ ons
revolution@@ ieren	revolution@@ ize
ein@@ schrän@@ kungen	con@@ stra@@ in@@ ts
gel@@ ang@@ wei@@ lt	bor@@ ed
wä@@ sche	laun@@ dry
berei@@ t@@ schaft	will@@ ing@@ ness
sa@@ ft	ju@@ ice
mehr@@ eren	multiple
blo@@ go@@ sphäre	blo@@ go@@ sphere
beein@@ dru@@ cken	im@@ press
verbreitet	spre@@ ads
nach@@ kommen	off@@ spring
tür@@ me	to@@ wers
ein@@ kauf@@ s@@ zentrum	sh@@ opp@@ ing
überrasch@@ ungen	surpris@@ es
196@@ 0ern	196@@ 0s
ku@@ pf@@ er	cop@@ per
fru@@ cht@@ fliegen	fru@@ it
orten	lo@@ cations
dau@@ er	du@@ ration
fehl@@ ern	mistakes
gewä@@ ss@@ ern	wat@@ ers
nahe@@ zu	virtu@@ ally
sensor@@ ische	sensor@@ y
sp@@ ri@@ tze	sy@@ r@@ inge
diplo@@ ma@@ ten	diplo@@ ma@@ ts
reak@@ toren	re@@ ac@@ tors
intro@@ verti@@ erte	intro@@ ver@@ ts
ge@@ lieb@@ ten	belo@@ ved
ge@@ fei@@ ert	cele@@ br@@ ated
schwe@@ fel	su@@ l@@ fu@@ r
steu@@ er	ta@@ x
defini@@ tionen	defini@@ tions
mittleren	midd@@ le-@@ a@@ ged
autor@@ itä@@ re	auth@@ or@@ it@@ arian
frü@@ he@@ sten	earli@@ est
trägt	car@@ ries
deut@@ schen	ger@@ man@@ s
beschrei@@ b@@ ungen	descri@@ p@@ tions
geno@@ ssen	enjo@@ yed
entfern@@ ten	dist@@ ant
über@@ ge@@ wichtig	over@@ weight
tor	gate
frei@@ heiten	free@@ dom@@ s
mö@@ n@@ ch	mon@@ k
geräusche	no@@ is@@ es
sicherheits@@ rat	coun@@ cil
s@@ än@@ ger	sing@@ ers
ein@@ geschlossen	lo@@ cked
beschle@@ uni@@ gt	acceler@@ ating
ver@@ einfachen	simpli@@ fy
sorge	conc@@ ern
zu@@ zuhören	listening
g@@ rie@@ chen@@ land	gre@@ e@@ ce
vorher@@ seh@@ bar	predic@@ table
respe@@ kti@@ ert	respe@@ cted
zeuge	wit@@ ness
be@@ wei@@ st	pro@@ ves
ver@@ a@@ chtung	con@@ temp@@ t
prin@@ z@@ ess@@ in	prin@@ cess
bio@@ materialien	bio@@ materials
aus@@ ger@@ ot@@ tet	er@@ a@@ dic@@ ated
für@@ chte	afraid
b@@ ör@@ se	stock
dat@@ ei	fi@@ le
la@@ sche	fla@@ p
liefer@@ ket@@ te	supply
tsch@@ k	ch@@ k
büro@@ kratie	bu@@ re@@ au@@ cra@@ cy
arbeits@@ los	un@@ emplo@@ yed
zun@@ eig@@ ung	affe@@ ction
kennen	knowing
kö@@ st@@ lich	deli@@ cious
kin@@ o	cin@@ em@@ a
kir@@ chen	chur@@ ches
erstens	fir@@ stly
kämp@@ ft	fighting
trans@@ zen@@ den@@ z	tran@@ scen@@ dence
dete@@ ktoren	dete@@ c@@ tors
hand@@ schuhe	glo@@ ves
budd@@ hi@@ stischen	budd@@ h@@ ist
richtigen	pro@@ per
konz@@ erte	con@@ cer@@ ts
stür@@ me	stor@@ ms
spezi@@ alisierung	speci@@ alization
überra@@ schen@@ der@@ weise	surpris@@ ingly
köni@@ g@@ innen	que@@ ens
entschei@@ det	deci@@ des
verwir@@ r@@ end	conf@@ using
ver@@ kün@@ dete	announ@@ ced
eigen@@ interesse	self-@@ interest
einzu@@ fangen	capture
wissenschaften	sci@@ ences
hielt	held
bestehen	ins@@ ist
kehr@@ te	re@@ turned
ir@@ on@@ isch	ir@@ onic
gan@@ z@@ heit	wh@@ ol@@ eness
lehr@@ bücher	text@@ books
no@@ ti@@ z@@ buch	not@@ e@@ book
entsch@@ lossen@@ heit	determin@@ ation
schreck@@ lichen	horri@@ ble
afgh@@ an@@ ische	afgh@@ an
pf@@ licht	du@@ ty
gewinn@@ e	prof@@ its
in@@ ji@@ zieren	inje@@ ct
sä@@ ure	ac@@ id
konsu@@ miert	consum@@ ed
ga@@ st@@ geber	ho@@ st
proz@@ ess@@ or	process@@ or
ent@@ ste@@ hung	emergen@@ ce
konfron@@ tieren	con@@ front
grö@@ ßen	si@@ zes
dr@@ ing@@ lichkeit	ur@@ gen@@ cy
erwachsen@@ en@@ alter	adul@@ tho@@ od
ge@@ dru@@ ckt	prin@@ ted
meeres@@ frü@@ chte	se@@ af@@ o@@ od
z@@ immer@@ geno@@ ss@@ in	ro@@ om@@ mate
offen@@ bar@@ ung	re@@ vel@@ ation
kr@@ ater	cr@@ ater
lo@@ y@@ alität	lo@@ y@@ al@@ ty
besit@@ zt	ow@@ ns
ange@@ zogen	attra@@ cted
infe@@ k@@ tion@@ sk@@ r@@ ank@@ heiten	infe@@ c@@ tious
gen@@ f	gen@@ ev@@ a
anzu@@ gehen	t@@ ack@@ le
schla@@ ge	pro@@ pose
magne@@ te	magne@@ ts
magne@@ ten	mag@@ net
wieder@@ hol@@ te	repe@@ ated
angeb@@ lich	sup@@ pos@@ ed@@ ly
gefallen	fallen
rechen@@ schaft	accoun@@ t@@ ability
ver@@ bringt	sp@@ ends
be@@ fe@@ hl	comm@@ and
gefü@@ tter@@ t	f@@ ed
tempor@@ äre	temporary
myster@@ i@@ ö@@ se	myster@@ i@@ ous
ab@@ schied	go@@ od@@ b@@ ye
nen@@ ner	den@@ om@@ in@@ ator
hei@@ mlich	secre@@ tly
glü@@ h@@ wür@@ m@@ chen	fire@@ flies
z@@ enti@@ meter	in@@ ch
ge@@ flo@@ gen	flo@@ wn
mutter@@ lei@@ b	wom@@ b
mikrosk@@ op@@ isch	microscop@@ ic
pal@@ ast	pal@@ ace
rech@@ te@@ ck	rec@@ tan@@ gle
gest@@ res@@ st	st@@ ressed
lauf@@ band	tre@@ ad@@ mil@@ l
groß@@ mütter	grand@@ mothers
an@@ zeigen	ads
her@@ steller	manufac@@ tur@@ er
ver@@ lan@@ gt	dem@@ ands
gerne	li@@ kes
auf@@ treten	occu@@ r
rä@@ um@@ liche	spa@@ tial
mittel@@ meer	medi@@ ter@@ ran@@ e@@ an
inst@@ abili@@ tät	inst@@ ability
er@@ re@@ gung	ar@@ ou@@ sal
dien@@ er	ser@@ v@@ ant
zu@@ frieden@@ heit	satis@@ fac@@ tion
o@@ ster@@ insel	e@@ aster
auto@@ fahren	driving
spiel@@ er@@ isch	play@@ ful
theore@@ tische	theore@@ tical
wür@@ dig	wor@@ thy
auf@@ klär@@ ung	en@@ ligh@@ ten@@ ment
wa@@ is@@ en@@ haus	or@@ phan@@ age
un@@ gleich@@ gewicht	im@@ balance
kompon@@ ist	com@@ pos@@ er
bo@@ hr@@ er	dri@@ ll
zu@@ ver@@ sichtlich	confi@@ dent
aus@@ wählen	pick
ex@@ o@@ tische	ex@@ o@@ tic
mittel@@ alter@@ liche	medi@@ ev@@ al
außen@@ minister@@ in	secre@@ t@@ ary
selbst@@ wert@@ gefühl	self-@@ worth
stär@@ k@@ sten	stron@@ gest
sk@@ ri@@ p@@ te	scri@@ p@@ ts
hängen	hang
spiritu@@ alität	spiritu@@ ality
schla@@ cht@@ feld	bat@@ t@@ le@@ field
aus@@ reden	exc@@ uses
erfü@@ ll@@ ung	ful@@ fil@@ l@@ ment
be@@ festi@@ gt	atta@@ ched
symme@@ tr@@ ische	symme@@ tri@@ cal
ver@@ stor@@ benen	de@@ ce@@ ased
schw@@ am@@ m	swa@@ m
ab@@ gelen@@ kt	di@@ stra@@ cted
explo@@ sionen	explo@@ sions
k@@ au@@ l@@ qu@@ app@@ en	ta@@ d@@ po@@ les
behinder@@ ungen	dis@@ abilities
implan@@ tiert	implan@@ ted
be@@ ste@@ chung	bri@@ be
lieben	lo@@ ving
193@@ 0ern	193@@ 0s
anteil	propor@@ tion
x-@@ achse	x-@@ axis
revolution@@ äre	revolution@@ ary
gele@@ hr@@ ten	sch@@ ol@@ ars
verhaltens@@ ökonom@@ ie	behavi@@ oral
zusammen@@ bruch	break@@ down
y-@@ achse	y-@@ axis
ander@@ s@@ arti@@ gkeit	o@@ th@@ ern@@ ess
mon@@ sun	mon@@ soon
sta@@ ch@@ eln	sp@@ ines
kl@@ auen	cla@@ ws
unter@@ bro@@ chen	inter@@ rup@@ ted
wä@@ ge@@ zelle	load
augen@@ licht	sight
haus@@ hal@@ ts@@ geräte	appli@@ an@@ ces
kan@@ ad@@ ischen	can@@ adi@@ an
hy@@ äne	hy@@ en@@ a
all@@ mä@@ h@@ lich	gradu@@ ally
unter@@ ir@@ dischen	under@@ ground
unterneh@@ mer@@ ische	entrepr@@ en@@ eu@@ ri@@ al
reg@@ net	ra@@ ins
ver@@ drei@@ fa@@ cht	tri@@ pl@@ ed
elimin@@ ieren	elimin@@ ate
ver@@ sich@@ ere	as@@ sure
parado@@ x@@ erweise	parado@@ x@@ ically
be@@ tro@@ gen	che@@ ated
begeg@@ nungen	en@@ counter@@ s
er@@ run@@ gen@@ schaften	achie@@ v@@ ements
bo@@ hnen	be@@ ans
ras@@ en	law@@ ns
nieder@@ länder	du@@ tch
re@@ p@@ tili@@ en	re@@ p@@ ti@@ les
infor@@ mieren	in@@ form
un@@ zä@@ h@@ lige	coun@@ t@@ less
tö@@ dlich	de@@ ad@@ ly
gezogen	pulled
zi@@ tiert	quot@@ ed
prä@@ gte	co@@ ined
kopf@@ hör@@ er	head@@ phones
kom@@ position	com@@ position
gr@@ aus@@ am@@ keit	cru@@ el@@ ty
prü@@ fung	ex@@ am
gra@@ m@@ mati@@ k	gra@@ m@@ ma@@ r
sie@@ b@@ te	se@@ vent@@ h
aus@@ flug	trip
markt@@ platz	market@@ place
ge@@ fan@@ gen@@ en@@ dile@@ m@@ ma	pris@@ on@@ er
tran@@ sa@@ ktionen	trans@@ actions
deta@@ il@@ li@@ erte	deta@@ iled
ehe@@ männer	hus@@ b@@ ands
real@@ itäten	reali@@ ties
ment@@ alität	ment@@ ality
die@@ b@@ sta@@ hl	the@@ ft
hoch@@ geladen	u@@ plo@@ aded
versch@@ wen@@ det	wa@@ sted
benötigt	requi@@ red
schei@@ ben	sli@@ ces
bedeu@@ tungs@@ los	meaning@@ less
erweiter@@ t	exp@@ and@@ ed
schil@@ d@@ kr@@ ö@@ te	tur@@ tle
hä@@ up@@ t@@ ling	ch@@ ie@@ f
feuer@@ we@@ hr@@ mann	fire@@ man
an@@ fragen	re@@ que@@ sts
interak@@ tivität	inter@@ activity
gewi@@ d@@ met	de@@ vot@@ ed
durch@@ brü@@ che	break@@ through@@ s
sch@@ ach	ch@@ ess
ver@@ glei@@ cht	compar@@ ing
über@@ wäl@@ ti@@ gende	over@@ wh@@ el@@ ming
zu@@ ver@@ lässi@@ g	reli@@ able
erweiter@@ te	exten@@ ded
ei@@ ch@@ hör@@ n@@ chen	squ@@ ir@@ re@@ l
person@@ alisierung	person@@ alization
er@@ wer@@ ben	ac@@ qui@@ re
fahrt	ride
künst@@ lich	arti@@ fi@@ cially
angenommen	as@@ sum@@ ed
manipu@@ liert	mani@@ pul@@ ated
geschen@@ ke	gif@@ ts
erstaun@@ licherweise	ama@@ z@@ ingly
log@@ isch	logi@@ cal
ent@@ führt	kid@@ na@@ pped
ph@@ as@@ en	st@@ ages
sü@@ ß@@ igkeiten	c@@ and@@ y
urban@@ isi@@ erung	ur@@ b@@ ani@@ zation
kopf@@ schmerzen	hea@@ da@@ ches
un@@ end@@ lichkeit	infin@@ ity
einge@@ fangen	cap@@ tured
jahrhunderts	21@@ st-@@ century
erleben	experi@@ en@@ cing
ge@@ fan@@ gen@@ schaft	cap@@ tivity
bus@@ h-@@ regierung	admini@@ stration
nieder@@ lage	de@@ fe@@ at
fe@@ dern	fe@@ a@@ thers
ge@@ d@@ ei@@ hen	thri@@ ve
hing@@ eri@@ chtet	ex@@ ecu@@ ted
krebs@@ arten	can@@ cers
genau@@ igkeit	accu@@ ra@@ cy
sonnen@@ unter@@ gang	sun@@ set
zä@@ une	f@@ ences
selb@@ stor@@ gan@@ is@@ ation	self-@@ organization
anal@@ o@@ gi@@ en	anal@@ o@@ gi@@ es
ge@@ war@@ tet	wa@@ ited
spiel@@ dynam@@ i@@ ken	dynam@@ ics
zwei@@ dimension@@ alen	two-@@ dimensional
mäd@@ els	girls
brasili@@ anischen	brazi@@ li@@ an
korre@@ k@@ theit	cor@@ rec@@ t@@ ness
un@@ angeneh@@ m	un@@ comfortable
zwan@@ gs@@ läu@@ fi@@ g	inevi@@ t@@ ably
ans@@ ä@@ tze	approach@@ es
person@@ alisi@@ erte	person@@ alized
sing@@ t	sing@@ ing
gesch@@ la@@ fen	sle@@ pt
domin@@ anz	domin@@ ance
vermögen	asse@@ ts
refle@@ xi@@ on	refle@@ ction
schw@@ ing@@ ungen	vi@@ bra@@ tions
beantworten	ans@@ wer@@ ing
kri@@ ti@@ siert	cri@@ ti@@ ci@@ zed
dol@@ me@@ tsch@@ erin	transl@@ ator
kore@@ an@@ isch	kore@@ an
dom@@ inieren	domin@@ ate
fort@@ pflan@@ zung	re@@ production
nor@@ do@@ sten	nor@@ the@@ ast
kr@@ ücken	cru@@ t@@ ches
brie@@ f@@ tasche	wal@@ let
ero@@ tische	ero@@ tic
über@@ fluss	ab@@ und@@ ance
kühl@@ sch@@ r@@ ank	re@@ fri@@ ger@@ ator
gest@@ alt	shape
ver@@ pac@@ kung	pac@@ k@@ aging
unterstützung	assi@@ stance
ma@@ ssen	mas@@ ses
sie@@ d@@ lungen	sett@@ le@@ ments
eingesetzt	de@@ plo@@ yed
dunkel@@ sten	dar@@ k@@ est
sk@@ ri@@ pt	scri@@ pt
50@@ 0.000	50@@ 0,000
ein@@ fall@@ s@@ rei@@ cht@@ um	in@@ genu@@ ity
sch@@ weiß	swe@@ at
7@@ 0@@ 0.000	7@@ 0@@ 0,000
nord@@ westen	nor@@ th@@ west
tie@@ fen	dep@@ ths
enth@@ ü@@ llen	reve@@ al
gesetz@@ geb@@ ung	leg@@ is@@ lation
gras@@ land	gras@@ s@@ lands
kapit@@ eln	chap@@ ters
herz@@ kla@@ ppe	val@@ ve
finger@@ ab@@ druck	finger@@ print
ent@@ span@@ nt	rela@@ x@@ ed
ma@@ il@@ and	mil@@ an
liefer@@ anten	supp@@ li@@ ers
jugend@@ lichen	ad@@ oles@@ cents
k@@ ie@@ fer	ja@@ w
sand@@ kör@@ ner	gra@@ ins
kra@@ wat@@ te	tie
lin@@ k@@ sh@@ än@@ der	le@@ ft@@ -@@ hand@@ ed
durch@@ dr@@ ingen	pen@@ et@@ rate
geschwindi@@ gkeiten	spee@@ ds
res@@ on@@ anz	res@@ on@@ ance
schlie@@ ßt	inclu@@ des
ven@@ en	v@@ eins
frem@@ d@@ heit	stran@@ gen@@ ess
bä@@ cker@@ ei	bak@@ ery
befindet	lo@@ cated
anony@@ mit@@ ät	anony@@ m@@ ity
best@@ äu@@ ber	pol@@ lin@@ ators
gur@@ ke	cu@@ cum@@ ber
schä@@ men	as@@ ham@@ ed
energi@@ en	energi@@ es
frei@@ gesetzt	rele@@ ased
off@@ enen	open-@@ heart
au@@ stern	o@@ y@@ sters
tumor@@ therap@@ ie@@ felder	tre@@ ating
sti@@ ck@@ stoff@@ mon@@ ox@@ id	ni@@ tri@@ c
ein@@ gang	ent@@ r@@ ance
rau@@ igkeit	rou@@ g@@ hn@@ ess
stau@@ geb@@ ü@@ hren	con@@ ge@@ sti@@ on
verknü@@ pf@@ te	lin@@ ked
neuro@@ log@@ ische	neuro@@ logi@@ cal
fun@@ ken	spar@@ k
sper@@ r@@ holz	pl@@ y@@ wood
kap@@ stadt	town
stö@@ cken	sti@@ cks
u@@ hren	clo@@ cks
frei@@ wi@@ llig	volunte@@ er
ni@@ chte	nie@@ ce
sozi@@ ologen	soci@@ ologists
i@@ mi@@ tiert	mi@@ mi@@ cs
beru@@ fe	professi@@ ons
heraus@@ ge@@ fordert	challen@@ ged
chirur@@ g@@ ischen	sur@@ gical
gehei@@ lt	cu@@ red
schei@@ dung	di@@ vor@@ ce
sozial@@ hilfe	wel@@ f@@ are
ent@@ span@@ nung	rela@@ x@@ ation
ber@@ ück@@ sichti@@ gt	account
mikro@@ sekunden	micro@@ seconds
predi@@ gt	ser@@ mon
ver@@ nach@@ lässi@@ gt	ne@@ g@@ le@@ cted
bibliothe@@ k@@ are	libr@@ ari@@ ans
ges@@ can@@ nt	scan@@ ned
digit@@ alisiert	di@@ gi@@ ti@@ zed
be@@ wunder@@ ung	ad@@ mi@@ ration
er@@ leu@@ chtung	epi@@ ph@@ any
inje@@ ktion	inje@@ ction
hum@@ m@@ eln	bu@@ m@@ ble@@ bees
sch@@ ne@@ cke	sna@@ il
best@@ äu@@ bung	pol@@ lin@@ ation
d@@ än@@ ische	dan@@ ish
unter@@ wä@@ sche	under@@ wear
zu@@ stimmung	con@@ sent
miss@@ verstanden	mis@@ understood
über@@ setz@@ ungen	trans@@ lations
vern@@ ün@@ f@@ tige	reas@@ on@@ able
rech@@ nen	calcul@@ ating
gefähr@@ dete	en@@ danger@@ ed
nation@@ alismus	nation@@ alism
simu@@ la@@ tionen	simu@@ lations
entscheiden@@ d	cru@@ cial
entstand	emer@@ ged
arti@@ keln	artic@@ les
sinn@@ vollen	meaning@@ ful
4@@ 0ern	4@@ 0s
kommuni@@ stischen	commun@@ ist
anal@@ p@@ hab@@ e@@ ten	il@@ liter@@ ate
zu@@ gelassen	appro@@ ved
pro@@ vin@@ zen	pro@@ vin@@ ces
ver@@ s@@ öhn@@ ung	re@@ con@@ ci@@ li@@ ation
perfe@@ ktion	perfe@@ ction
verkauf@@ te	selling
palä@@ on@@ t@@ ologe	pal@@ e@@ on@@ t@@ ologist
kol@@ lagen	col@@ lagen
aku@@ stische	ac@@ ou@@ stic
explo@@ di@@ erte	explo@@ ded
²	squ@@ ared
spie@@ geln	mir@@ r@@ ors
unbe@@ ab@@ sichti@@ gte	un@@ inten@@ ded
ur@@ ein@@ wohner	na@@ tive
radi@@ ologen	radi@@ ologists
er@@ holt	re@@ covered
dar@@ win@@ ismus	dar@@ win@@ ism
an@@ erkennen	ac@@ knowledge
ein@@ sam	lon@@ ely
christ@@ ent@@ um	chri@@ sti@@ an@@ ity
un@@ sterb@@ lichkeit	im@@ mortality
je@@ derzeit	any@@ time
demo@@ gra@@ fische	demo@@ graphic
in@@ form@@ elle	infor@@ mal
ster@@ bende	dying
re@@ da@@ k@@ teure	edi@@ tors
sta@@ p@@ eln	st@@ ack
hö@@ hen	hei@@ ghts
wahrneh@@ m@@ ungen	per@@ cep@@ tions
bedeu@@ ts@@ am@@ keit	signi@@ fi@@ can@@ ce
lü@@ gt	lying
bel@@ ei@@ digung	insu@@ lt
st@@ eigen@@ de	ris@@ ing
lei@@ chter	ligh@@ ter
ägyp@@ tische	eg@@ yp@@ ti@@ an
ge@@ klei@@ det	d@@ ressed
zusammen@@ fassen	sum@@ mar@@ ize
um@@ lauf	circu@@ lation
gi@@ ft@@ stoffe	tox@@ ins
an@@ gelegenheit	issue
haupt@@ qu@@ arti@@ er	head@@ quar@@ ters
bild@@ schir@@ men	scre@@ ens
gehir@@ ner@@ schü@@ tter@@ ung	conc@@ us@@ sion
ab@@ geschlossen	comple@@ ted
symbo@@ li@@ sche	symbo@@ lic
be@@ fe@@ hle	comm@@ ands
sch@@ ere	sc@@ is@@ sor@@ s
sch@@ ar@@ f	shar@@ p
gei@@ st@@ es@@ krankheit	illness
einzigarti@@ g	uni@@ qu@@ ely
ver@@ hinder@@ t	pre@@ v@@ ents
ge@@ fal@@ tet	fol@@ ded
verti@@ k@@ al	ver@@ tically
gewe@@ hre	g@@ uns
ein@@ greifen	interven@@ e
elektro@@ de	electro@@ de
bibli@@ schen	bibli@@ cal
zusammen@@ fassung	sum@@ mary
gr@@ ä@@ ser	gras@@ ses
lehr@@ ling	app@@ r@@ enti@@ ce
kan@@ in@@ chen	rab@@ bits
über@@ holt	ob@@ so@@ le@@ te
pas@@ sa@@ gi@@ ere	pas@@ sen@@ gers
individu@@ alität	individu@@ ality
ver@@ stärken	am@@ pli@@ fy
ga@@ st@@ freund@@ schaft	hospit@@ ality
as@@ sozi@@ ieren	associ@@ ate
dau@@ er@@ haft	perman@@ ent
kon@@ ver@@ gen@@ z	conver@@ gen@@ ce
fahr@@ rä@@ der	bi@@ cy@@ cles
schü@@ tzt	prote@@ cts
nach@@ teil	dis@@ advantage
schau@@ spiel@@ erin	ac@@ tr@@ ess
sch@@ wert	s@@ word
be@@ wä@@ s@@ ser@@ ung	ir@@ ri@@ gation
bein@@ halten	inclu@@ de
funktion@@ elle	func@@ tional
infor@@ mi@@ erte	in@@ formed
ver@@ teilen	distribu@@ te
ge@@ zeichnet	dra@@ wn
pro@@ ze@@ du@@ r	proce@@ d@@ ure
geb@@ lieben	rema@@ ined
rück@@ en@@ mar@@ ks	cor@@ d
un@@ verändert	un@@ changed
nar@@ ben	sc@@ ars
astronom@@ ische	astronom@@ ical
hoch@@ land	hig@@ hl@@ ands
jung@@ frauen	virg@@ ins
kol@@ um@@ bi@@ en	col@@ om@@ bia
besch@@ issen	su@@ cks
ru@@ in@@ iert	ru@@ ined
folge	ep@@ iso@@ de
k@@ um@@ pel	bud@@ dy
rück@@ zug	re@@ treat
un@@ bewusst	un@@ consci@@ ously
man@@ us@@ kri@@ pt	man@@ us@@ cri@@ pt
a@@ ß	eating
annehmen	assu@@ me
nächste	ne@@ ar@@ est
glaub@@ wür@@ digkeit	cre@@ di@@ bility
regen@@ zeit	seas@@ on
ru@@ ck@@ s@@ ack	back@@ pack
um@@ gibt	surro@@ unds
quali@@ fiziert	quali@@ fied
fahr@@ sp@@ uren	lan@@ es
herstellen	manufac@@ ture
gö@@ tt@@ lichen	di@@ v@@ ine
säu@@ ge@@ tier	mam@@ mal
ähn@@ lichkeiten	simil@@ ari@@ ties
schei@@ be	dis@@ k
sü@@ chti@@ g	addi@@ cted
klei@@ der@@ bü@@ gel	co@@ at
vertei@@ di@@ ger	defen@@ ders
proz@@ ess@@ oren	process@@ ors
bewus@@ ste	conscious
ausge@@ drückt	expres@@ sed
schluss@@ fol@@ ger@@ ungen	conclu@@ sions
hypo@@ the@@ tische	hypo@@ the@@ tical
vor@@ orten	sub@@ ur@@ bs
ver@@ ga@@ ß	for@@ got
end@@ lose	end@@ less
pfei@@ l@@ spit@@ zen	ar@@ ro@@ whe@@ ads
glob@@ alisi@@ erten	glob@@ alized
bemerkens@@ wert	remark@@ ably
well@@ en@@ län@@ gen	wa@@ vel@@ eng@@ ths
un@@ fähigkeit	in@@ ability
ank@@ ün@@ digung	announ@@ c@@ ement
tour@@ ismus	tour@@ ism
ein@@ hor@@ n	un@@ ic@@ or@@ n
griff	hand@@ le
aus@@ zeich@@ nung	a@@ ward
kli@@ cks	cli@@ cks
freund@@ lich	friend@@ ly
präsent@@ ationen	pres@@ ent@@ ations
zen@@ siert	cen@@ sor@@ ed
gewal@@ t@@ lo@@ sigkeit	non@@ violence
trag@@ baren	port@@ able
el@@ tern@@ schaft	par@@ enting
aus@@ wen@@ dig	memor@@ i@@ zed
an@@ kommen	arri@@ ve
plat@@ ten	pl@@ ates
sy@@ na@@ go@@ ge	sy@@ na@@ go@@ gue
lei@@ det	suff@@ ers
ges@@ pen@@ det	don@@ ated
aus@@ stellungen	exhi@@ bi@@ tions
unter@@ brechen	inter@@ ru@@ pt
fahr@@ ten	ri@@ des
bab@@ el	bab@@ yl@@ on
rü@@ stung	ar@@ mor
ord@@ ner	fol@@ der
massen@@ aus@@ sterben	extin@@ ctions
ab@@ len@@ kungen	di@@ stra@@ ctions
ans@@ am@@ m@@ lung	accu@@ mu@@ lation
block@@ iert	blo@@ cked
stoff	cl@@ oth
demokra@@ ti@@ si@@ erung	democra@@ ti@@ zation
anthropo@@ lo@@ ge	anthropo@@ log@@ ist
instin@@ kte	instin@@ cts
alli@@ anz	alli@@ ance
194@@ 0ern	194@@ 0s
kompli@@ ment	compli@@ ment
häufig	frequ@@ ently
bank@@ wesen	ban@@ king
ide@@ ologischen	ide@@ ological
gar@@ anti@@ ert	guar@@ an@@ te@@ ed
wieder@@ hol@@ ung	repe@@ ti@@ tion
lan@@ ge@@ weile	bor@@ e@@ dom
nah@@ aufnahme	clo@@ se@@ -up
samm@@ lungen	colle@@ ctions
kohlen@@ wasser@@ stoffe	hydro@@ carb@@ ons
ök@@ olog@@ isch	e@@ col@@ o@@ gi@@ cally
ferti@@ gkeit	sk@@ ill
ta@@ kti@@ k	tac@@ tics
ver@@ hält	acts
ren@@ nt	runs
schla@@ chten	bat@@ tles
kämp@@ ften	f@@ ought
wir@@ ft	thro@@ ws
hinter@@ einander	row
entstehen	emer@@ ge
entsteht	emer@@ ges
entwick@@ ler	develop@@ ers
vertrau@@ ens@@ wür@@ dig	tru@@ st@@ wor@@ thy
arbeit@@ sk@@ raft	labor
frie@@ dlichen	pe@@ ac@@ e@@ ful
sch@@ na@@ pp@@ te	grab@@ bed
to@@ ma@@ ten	to@@ ma@@ to@@ es
geome@@ tr@@ ische	ge@@ om@@ et@@ ric
drei@@ st@@ elli@@ ge	three-@@ dig@@ it
an@@ wei@@ sung	instru@@ ction
ein@@ gestellt	hi@@ red
re@@ zep@@ toren	re@@ cep@@ tors
beri@@ chter@@ stat@@ tung	co@@ verage
palä@@ stin@@ en@@ sische	pal@@ est@@ ini@@ an
krea@@ tion@@ i@@ sten	crea@@ tion@@ ists
ag@@ no@@ stisch	ag@@ no@@ stic
relev@@ anz	relev@@ ance
tele@@ kommunikation	tele@@ communic@@ ations
et@@ ab@@ liert	establi@@ shed
zusammen@@ gebro@@ chen	collap@@ sed
glück@@ wunsch	con@@ gr@@ at@@ u@@ lations
nachhal@@ tig	sustain@@ ably
lei@@ se	quie@@ tly
ro@@ hre	pi@@ pes
ro@@ hr	pi@@ pe
finan@@ zen	fin@@ ance
k@@ nap@@ p	sc@@ ar@@ ce
kühl@@ er	cool@@ er
ver@@ träge	contra@@ cts
produ@@ z@@ ent	produ@@ cer
ewi@@ gkeit	e@@ ter@@ ni@@ ty
g@@ ür@@ tel	b@@ elt
zusammen@@ arbeiten	collabor@@ ate
k@@ äu@@ fer	bu@@ yers
verk@@ äu@@ fe	sal@@ es
an@@ zieh@@ ung	attra@@ ction
magne@@ tis@@ mus	magne@@ tis@@ m
verwir@@ r@@ ung	con@@ fusion
budd@@ h@@ ismus	budd@@ h@@ ism
schwer@@ ste	har@@ dest
psych@@ olog@@ isch	psych@@ ologi@@ cally
sal@@ z@@ wasser	sal@@ t@@ water
bren@@ nt	bur@@ ns
teilung	di@@ vision
wol@@ le	wo@@ ol
bel@@ gi@@ en	bel@@ gi@@ um
geld@@ geber	f@@ under@@ s
abhän@@ gt	depen@@ dent
dok@@ um@@ ent@@ ar@@ film	docum@@ ent@@ ary
schwar@@ m	s@@ warm
seit@@ wärts	si@@ de@@ ways
mä@@ chte	power@@ s
bru@@ tal@@ ität	bru@@ tality
er@@ ziehen	educ@@ ate
sk@@ ali@@ erung	sc@@ aling
hyper@@ aktivität	hyper@@ activity
auf@@ hört	st@@ ops
ab@@ teilung	department
um@@ gesetzt	imple@@ mented
ein@@ la@@ dungen	invi@@ tations
pri@@ mä@@ re	primary
hoff@@ te	hop@@ ed
pyrami@@ den	pyrami@@ ds
gan@@ z@@ heit@@ liche	ho@@ li@@ stic
haupt@@ grund	main
arbeitet	oper@@ ates
hypo@@ the@@ k	mor@@ t@@ ga@@ ge
ge@@ bet	pra@@ yer
verkehr@@ s@@ st@@ aus	j@@ ams
kan@@ u	can@@ o@@ e
regi@@ stri@@ ert	regi@@ ster@@ ed
lebens@@ span@@ ne	li@@ fes@@ pan
ehe@@ partner	spo@@ use
em@@ pf@@ än@@ ger	recei@@ ver
bre@@ m@@ se	bra@@ kes
zer@@ brech@@ lichkeit	fra@@ gi@@ li@@ ty
her@@ b@@ st	au@@ tu@@ m@@ n
erhö@@ hte	increas@@ ed
ab@@ le@@ hnen	re@@ f@@ use
kon@@ ven@@ tion	conven@@ tion
bi@@ ome@@ di@@ zin@@ ischen	bi@@ ome@@ di@@ cal
fein@@ d@@ se@@ li@@ gkeit	ho@@ sti@@ li@@ ty
du@@ mme	du@@ m@@ b
de@@ pri@@ mier@@ end	depres@@ sing
l@@ ingu@@ i@@ stische	l@@ ingu@@ i@@ stic
tu@@ genden	virtu@@ es
ex@@ tro@@ verti@@ erte	ex@@ tro@@ ver@@ ts
wahn@@ sinn	ma@@ dness
san@@ ft	soft@@ ly
vor@@ fall	inci@@ dent
i@@ di@@ oten	i@@ di@@ ots
fa@@ ch	subject
asi@@ a@@ tischen	asi@@ an
dis@@ kri@@ mini@@ erung	dis@@ crimin@@ ation
industri@@ alisi@@ erten	industri@@ alized
kriegs@@ führung	war@@ f@@ are
aus@@ schließlich	ex@@ clu@@ si@@ vely
bri@@ cht	brea@@ ks
wahrschein@@ lichkeiten	prob@@ abilities
plasti@@ zität	plasti@@ city
mo@@ sche@@ en	mo@@ squ@@ es
bedenken	concern@@ s
aus@@ führung	ex@@ ecu@@ tion
herz@@ schlag	he@@ art@@ beat
schreib@@ maschine	ty@@ pe@@ writer
emp@@ fangen	recei@@ ve
kon@@ struk@@ tionen	con@@ struc@@ tions
dreht	sp@@ inning
kam@@ mern	cham@@ bers
re@@ da@@ k@@ te@@ ur	edi@@ tor
gebur@@ ten	bir@@ ths
span@@ nungen	ten@@ sions
vor@@ freude	anti@@ ci@@ pa@@ tion
ak@@ ti@@ vis@@ mus	ac@@ ti@@ vis@@ m
besu@@ chte	vis@@ iting
über@@ blick	over@@ view
far@@ bi@@ gen	color@@ ed
be@@ greifen	gras@@ p
auto@@ fahrer	dri@@ vers
zwan@@ zi@@ gern	20@@ s
di@@ k@@ tat@@ ur	dic@@ tat@@ or@@ ship
rö@@ hren	tu@@ bes
rech@@ nungen	bil@@ ls
mö@@ r@@ der	mur@@ derer
personen	person@@ s
ge@@ po@@ stet	po@@ sted
schwe@@ dischen	swe@@ dis@@ h
mär@@ chen	fair@@ y
entschei@@ d@@ ung@@ str@@ ä@@ ger	poli@@ cy@@ makers
ober@@ sten	su@@ pre@@ me
unsicht@@ barkeit	invisi@@ bility
le@@ xi@@ k@@ on	le@@ xic@@ on
heili@@ gkeit	hol@@ iness
r@@ ön@@ t@@ gen@@ bild	x-@@ ray
au@@ ti@@ stische	au@@ ti@@ stic
planet@@ ar@@ ischen	planet@@ ary
rei@@ fen	ti@@ r@@ es
grün@@ deten	formed
mei@@ ster@@ werk	ma@@ ster@@ piece
fäl@@ scher	for@@ ger
zusammenge@@ fasst	sum@@ mar@@ i@@ zed
freien	out@@ door
vor@@ hän@@ ge	cur@@ tains
un@@ vorstell@@ bare	uni@@ mag@@ in@@ able
aufbauen	re@@ build
tal@@ enti@@ erten	tal@@ ented
unter@@ schä@@ tzt	under@@ esti@@ ma@@ ted
zusammen@@ fas@@ sungen	sum@@ mar@@ ies
rei@@ cht@@ um	rich@@ ness
er@@ wor@@ ben	ac@@ qui@@ red
sonder@@ barer	que@@ erer
demon@@ stra@@ tionen	demon@@ stra@@ tions
stimm@@ ten	agre@@ ed
bin@@ dungen	ties
kinder@@ arzt	pe@@ di@@ at@@ ri@@ cian
überqu@@ erte	cros@@ sed
effe@@ kti@@ ver	effectively
orienti@@ erung	ori@@ entation
neuro@@ wissenschaft@@ ler@@ in	neuro@@ scientist
abstra@@ ktionen	abstra@@ ctions
rech@@ ner@@ ischen	compu@@ ta@@ tional
kä@@ tz@@ chen	kit@@ tens
g@@ lie@@ d@@ maßen	lim@@ bs
vorstellungen	no@@ tions
rück@@ gr@@ at	back@@ bone
cha@@ o@@ tischen	cha@@ o@@ tic
auf@@ stand	u@@ pris@@ ing
h@@ üb@@ sche	lo@@ vely
prü@@ f@@ ungen	exam@@ s
be@@ häl@@ ter	contain@@ er
la@@ gern	cam@@ ps
ab@@ len@@ kung	di@@ stra@@ ction
krie@@ ger	war@@ ri@@ or
aus@@ drü@@ cke	expres@@ sions
wein@@ trau@@ be	gra@@ pe
bau@@ plan	blu@@ e@@ print
pf@@ la@@ ster	band@@ -@@ aid
te@@ k@@ ton@@ ischen	te@@ c@@ ton@@ ic
t@@ ank@@ stellen	sta@@ tions
schwe@@ ben	flo@@ at
subje@@ ktiven	subje@@ ctive
wand@@ te@@ pp@@ i@@ che	ta@@ pe@@ stri@@ es
mäch@@ tigen	mi@@ gh@@ ty
unter@@ kunft	hous@@ ing
fal@@ t@@ muster	cre@@ ase
strei@@ fen	stri@@ pes
besit@@ z	ow@@ ner@@ ship
schle@@ u@@ der	s@@ ling
p@@ fe@@ ff@@ er@@ spra@@ y	spra@@ y
re@@ zen@@ sionen	re@@ vie@@ ws
fis@@ cher@@ ei	fis@@ her@@ y
be@@ cher	cu@@ ps
200@@ -@@ jahr@@ -@@ plan	200@@ -@@ year
b@@ am@@ bus	b@@ am@@ bo@@ o
haus@@ meister	jan@@ it@@ ors
kil@@ ogra@@ mm	kil@@ ogra@@ m
nord@@ männer	nor@@ se
an@@ ä@@ mie	an@@ e@@ mi@@ a
ök@@ ologe	ec@@ ologist
sur@@ fer	sur@@ f@@ ers
hä@@ fen	por@@ ts
pi@@ oni@@ er@@ geist	pi@@ one@@ ering
un@@ vorher@@ seh@@ bar	un@@ predic@@ table
versu@@ ch@@ sper@@ son@@ en	subje@@ cts
hoff@@ nungs@@ voll	hop@@ e@@ ful
block@@ ieren	blo@@ cking
h@@ ür@@ den	barri@@ ers
absor@@ biert	absor@@ bs
privi@@ legi@@ ert	privi@@ le@@ ged
kühl@@ ung	re@@ fri@@ ger@@ ation
er@@ satz	sub@@ stit@@ ute
tau@@ b@@ heit	de@@ af@@ ness
nation@@ alität	nation@@ ality
vari@@ ieren	v@@ ary
solar@@ kolle@@ ktoren	pan@@ els
währ@@ ungen	cur@@ ren@@ cies
in@@ trin@@ sische	in@@ trin@@ si@@ c
schwier@@ igkeit	diffic@@ ul@@ ty
funktion@@ alität	func@@ tion@@ ality
respe@@ kt@@ voll	respe@@ ct@@ ful
ka@@ the@@ dr@@ alen	ca@@ the@@ dr@@ als
pa@@ p@@ st	po@@ pe
klo@@ ster	mon@@ a@@ ster@@ y
palä@@ stin@@ en@@ ser	pal@@ est@@ ini@@ ans
vi@@ tal@@ ität	vi@@ tality
ein@@ ger@@ eicht	sub@@ mit@@ ted
viel@@ ver@@ sprech@@ end	promis@@ ing
illu@@ stri@@ ert	illu@@ str@@ ates
ver@@ sammeln	ga@@ ther
einfach@@ ere	simpl@@ er
be@@ merk@@ ungen	re@@ mar@@ ks
pin@@ sel	pain@@ t@@ br@@ ush
ge@@ hor@@ chen	o@@ be@@ y
er@@ run@@ gen@@ schaft	achie@@ vement
wunder@@ schön	beauti@@ fully
krea@@ tion@@ ismus	crea@@ tion@@ ism
verwandelt	trans@@ forms
ne@@ ffen	ne@@ p@@ he@@ ws
tre@@ ppen	sta@@ irs
vertrau@@ theit	famili@@ ar@@ ity
sensi@@ bili@@ tät	sensi@@ tivity
al@@ ar@@ man@@ lage	al@@ arm
strö@@ m@@ ungen	curr@@ ents
dopp@@ el@@ heli@@ x	heli@@ x
p@@ fa@@ de	path@@ ways
welt@@ klasse	worl@@ d-@@ class
vor@@ führung	dem@@ o
zusammen@@ bauen	assem@@ ble
be@@ zahl@@ ung	pay@@ ment
minister@@ ium	mini@@ stry
k@@ as@@ ach@@ stan	ka@@ z@@ ak@@ h@@ stan
pä@@ da@@ go@@ gen	educ@@ ators
soli@@ dar@@ ität	soli@@ dar@@ ity
geb@@ ü@@ hr	fe@@ e
an@@ grei@@ fer	attac@@ ker
stimu@@ liert	stimu@@ late
schw@@ än@@ ze	ta@@ ils
versch@@ wenden	wa@@ sting
ta@@ schen@@ rech@@ ner	calcul@@ ator
aufge@@ deckt	reve@@ aled
unterschei@@ det	dist@@ ingu@@ ish@@ es
schil@@ d@@ kr@@ ö@@ ten	tur@@ tles
sch@@ malen	nar@@ row
w@@ öl@@ fe	wol@@ ves
ord@@ entlich	proper@@ ly
gewe@@ hr	ri@@ f@@ le
ge@@ wür@@ ze	sp@@ ices
ähn@@ lichkeit	simil@@ ar@@ ity
kli@@ sche@@ es	stere@@ ot@@ yp@@ es
mexi@@ kan@@ ischen	mexi@@ can
vi@@ k@@ tor@@ i@@ anischen	vic@@ tor@@ ian
er@@ schw@@ ing@@ lichkeit	aff@@ ord@@ ability
überzeu@@ gung	con@@ vi@@ ction
de@@ zentr@@ alisiert	de@@ cent@@ r@@ alized
fest@@ nahme	ar@@ rest
mu@@ tiert	mu@@ tat@@ es
auto@@ mati@@ sche	auto@@ matic
leu@@ chten	sh@@ ining
neben@@ einander	si@@ de-@@ b@@ y-@@ side
redu@@ zi@@ erung	re@@ duc@@ ing
der@@ e@@ gu@@ li@@ erung	der@@ e@@ gu@@ lation
lo@@ b@@ by@@ i@@ sten	lo@@ b@@ by@@ ists
um@@ schlag	en@@ vel@@ op@@ e
enten	du@@ cks
bio@@ kraft@@ stoffe	bio@@ fu@@ els
nah@@ t@@ los	se@@ am@@ less@@ ly
jac@@ ke	jac@@ ket
e@@ go@@ i@@ stisch	sel@@ fish
ge@@ ologie	ge@@ ology
k@@ issen	pil@@ low
er@@ mäch@@ tigung	em@@ power@@ ment
sp@@ ri@@ tzen	sy@@ ring@@ es
ras@@ ch	rapi@@ dly
fi@@ bon@@ acci@@ -@@ zahlen	fi@@ bon@@ acc@@ i
berech@@ net	calcul@@ ated
sin@@ ken	sin@@ k
er@@ ben	in@@ her@@ it
ku@@ geln	sp@@ her@@ es
konzentri@@ erte	concent@@ r@@ ated
ver@@ arbeitet	process@@ ed
schmerzen	pa@@ ins
wahn@@ vorstellungen	del@@ u@@ sions
er@@ kunden	explor@@ ing
behalten	keeping
ira@@ k@@ ischen	ira@@ q@@ i
re@@ präsent@@ ative	repres@@ ent@@ ative
üben	practic@@ ing
unter@@ seite	under@@ side
le@@ gend@@ äre	le@@ gen@@ dar@@ y
aus@@ gelöst	caused
tö@@ teten	killing
auf@@ tritt	occur@@ s
kreu@@ z@@ wor@@ trä@@ t@@ sel	cro@@ ss@@ word
bürger@@ stei@@ g	si@@ de@@ walk
k@@ amer@@ un	c@@ amer@@ o@@ on
wunder@@ schönen	gor@@ ge@@ ous
pro@@ ze@@ dur@@ en	proce@@ dur@@ es
perfe@@ k@@ tion@@ iert	perfe@@ cted
beru@@ fs@@ leben	work@@ force
zahn@@ ärzte	den@@ ti@@ sts
unter@@ hal@@ ts@@ am@@ en	entertain@@ ing
kre@@ di@@ t@@ karte	card
stör@@ t	bo@@ thers
ne@@ un@@ jährige	nin@@ e-@@ year-old
pat@@ enti@@ ert	pat@@ ented
großartigen	magni@@ fi@@ cent
kro@@ a@@ ti@@ en	cro@@ a@@ ti@@ a
anal@@ o@@ gen	anal@@ o@@ g
ver@@ scho@@ ben	shif@@ ted
wir@@ bel@@ säu@@ le	sp@@ ine
frei@@ setzen	rele@@ ase
ein@@ log@@ gen	lo@@ g
kr@@ an	c@@ ran@@ e
auf@@ züge	el@@ ev@@ ators
ar@@ al@@ see	ar@@ al
er@@ träge	y@@ i@@ el@@ ds
klin@@ ische	trial
bes@@ e@@ tzen	occu@@ p@@ y
al@@ b@@ ani@@ en	al@@ b@@ ania
hel@@ den@@ hafte	hero@@ ic
aus@@ brü@@ che	out@@ brea@@ ks
kle@@ tt@@ ver@@ schluss	vel@@ cr@@ o
di@@ cke	thi@@ ck@@ ness
über@@ schätzen	over@@ esti@@ mate
intellektu@@ ell	intellec@@ tu@@ ally
ent@@ täusch@@ ung	dis@@ ap@@ poin@@ t@@ ment
all@@ ein@@ sein	soli@@ tude
un@@ glück@@ lichen	un@@ fortun@@ ate
f@@ ass	bar@@ re@@ l
ge@@ feu@@ ert	fi@@ red
gel@@ ungen	succe@@ e@@ ded
kämp@@ fer	figh@@ ters
bet@@ on@@ ung	em@@ ph@@ as@@ is
geogra@@ ph@@ isch	geogra@@ phi@@ cally
nahe	ne@@ ar@@ by
ma@@ x@@ im@@ alen	ma@@ x@@ im@@ um
ung@@ ar@@ n	h@@ ung@@ ary
spezi@@ alisiert	speci@@ alized
rufen	shou@@ ting
fei@@ er	celebra@@ tion
über@@ ein@@ stimmung	match
un@@ bedeu@@ tend	in@@ significant
mit@@ tag	noon
ge@@ treten	ki@@ cked
techn@@ ologe	technolog@@ ist
robo@@ tische	robo@@ tic
mis@@ sionen	mis@@ sions
ser@@ viert	ser@@ ved
proble@@ m@@ lösen	solving
anpas@@ sungen	adap@@ tations
kü@@ sse	k@@ is@@ ses
zei@@ ta@@ ch@@ se	ti@@ mel@@ ine
lang@@ samkeit	slow@@ ness
brie@@ f@@ mar@@ ke	stam@@ p
ste@@ tho@@ sk@@ op	ste@@ tho@@ scop@@ e
be@@ auf@@ tra@@ gt	com@@ mis@@ sion@@ ed
ein@@ samkeit	lon@@ el@@ iness
verein@@ bar	com@@ pati@@ ble
gegensei@@ tigkeit	reci@@ pro@@ city
ei@@ fer@@ sucht	je@@ al@@ ous@@ y
auf@@ rech@@ ter@@ halten	susta@@ in
bot@@ schaf@@ ter	am@@ bas@@ sa@@ d@@ or
er@@ lösung	re@@ de@@ mption
no@@ bel@@ prei@@ str@@ ä@@ ger	lau@@ re@@ ates
selbst@@ mor@@ dat@@ tent@@ ä@@ ter	bom@@ bers
privat@@ leben	wor@@ k-@@ life
ver@@ letzten	in@@ ju@@ red
flie@@ ß@@ end	flu@@ ent
aus@@ drücken	expres@@ sing
hu@@ b@@ ble@@ -@@ wel@@ trau@@ m@@ teles@@ ko@@ p	hu@@ b@@ ble
natur@@ ge@@ mä@@ ß	naturally
ver@@ folgt	tracking
zauber@@ er	wi@@ z@@ ard
hö@@ hlen@@ mal@@ er@@ ei@@ en	pain@@ t@@ ings
hand@@ lung	p@@ lot
schlä@@ ft	sle@@ e@@ ps
skep@@ tiker	skep@@ tics
austr@@ al@@ ische	austr@@ ali@@ an
stecken	putting
ration@@ alität	ration@@ ality
zurück@@ gewi@@ esen	re@@ je@@ cted
sozi@@ ologie	soci@@ ology
ge@@ häl@@ ter	wa@@ ges
san@@ it@@ är@@ einrichtungen	san@@ it@@ ation
wider@@ sprechen	dis@@ agree
kühl@@ schrän@@ ke	re@@ fri@@ ger@@ ators
ta@@ ge@@ buch	di@@ ary
k@@ auf	pur@@ ch@@ ase
bin@@ -@@ la@@ den@@ ismus	bin
stir@@ l@@ ing@@ motor	stir@@ ling
überqu@@ erung	cros@@ sing
außen	out@@ ward
demon@@ str@@ anten	prote@@ sters
emp@@ ir@@ ische	em@@ pi@@ ri@@ cal
wider@@ sprü@@ che	con@@ tradi@@ ctions
zer@@ ti@@ fi@@ k@@ at	cer@@ ti@@ fic@@ ate
wander@@ tau@@ ben	pas@@ sen@@ ger
kl@@ onen	c@@ lon@@ ing
erkrank@@ ungen	ill@@ n@@ esses
klassen@@ räume	class@@ rooms
beschrän@@ kungen	limit@@ ations
kon@@ ven@@ tionen	conven@@ tions
k@@ ak@@ er@@ la@@ ken	cock@@ ro@@ ach@@ es
still@@ stand	gri@@ d@@ lock
ab@@ kommen	treat@@ y
feu@@ ert	fir@@ es
sele@@ ktiv	sel@@ ec@@ tively
gene@@ tiker	gene@@ tic@@ ist
bas@@ en	bas@@ es
wan@@ gen	che@@ e@@ ks
kom@@ mer@@ zi@@ ell	commer@@ cially
ozean@@ ograph@@ ie	oce@@ an@@ ograph@@ y
auf@@ satz	es@@ say
red@@ und@@ anz	red@@ und@@ an@@ cy
disku@@ tiert	discus@@ sing
gewinn@@ orienti@@ erten	for@@ -@@ profit
schni@@ tte	cu@@ ts
pri@@ m@@ zahlen	pri@@ mes
epide@@ mi@@ ologen	epide@@ mi@@ ologists
auf@@ trieb	li@@ ft
be@@ ul@@ en	bu@@ mp@@ s
wähl@@ er@@ isch	pi@@ cky
kor@@ rela@@ tionen	cor@@ rela@@ tions
tan@@ zten	dan@@ ced
sch@@ ru@@ mp@@ fen	s@@ hr@@ ink
kla@@ ppe	shu@@ t
bei@@ fang	by@@ catch
sch@@ ot@@ tischen	scot@@ tish
k@@ auen	che@@ wing
r@@ he@@ tor@@ ik	r@@ he@@ tor@@ ic
vor@@ rä@@ te	supp@@ lies
ung@@ ar@@ ischen	h@@ ung@@ arian
luft@@ feu@@ chtigkeit	hu@@ mi@@ di@@ ty
ver@@ wü@@ stung	de@@ va@@ station
la@@ chs	sal@@ mon
best@@ äu@@ ben	pol@@ lin@@ ate
nahr@@ ung@@ ser@@ gän@@ z@@ ungs@@ mittel	supp@@ le@@ ments
an@@ gesicht	fac@@ e-@@ to-@@ face
wör@@ ter@@ bücher	dic@@ tion@@ aries
toler@@ ieren	toler@@ ate
sch@@ wie@@ ger@@ mutter	mo@@ ther@@ -@@ in-@@ law
sau@@ ber@@ er	cle@@ aner
schw@@ ö@@ re	swe@@ ar
ar@@ z@@ nei@@ mittel@@ -@@ pat@@ ent@@ gemeinschaft	medi@@ cin@@ es
sub@@ tra@@ ktion	sub@@ tra@@ ction
kreu@@ z@@ -@@ fünf	clu@@ bs
hand@@ schrift	hand@@ writing
be@@ un@@ ruhi@@ gt	concerned
geheim@@ dien@@ ste	agen@@ cies
ju@@ go@@ sla@@ wi@@ en	y@@ u@@ go@@ sla@@ via
obje@@ k@@ tivität	obje@@ c@@ tivity
neu@@ tr@@ alität	neu@@ tr@@ ality
sin@@ ken@@ de	dec@@ lin@@ ing
ein@@ s-@@ zu@@ -@@ eins	one-@@ on-@@ one
he@@ br@@ ä@@ ischen	he@@ bre@@ w
lin@@ k@@ sli@@ ber@@ ale	liber@@ als
ko@@ st@@ bar	pre@@ cious
rück@@ sicht@@ slo@@ sigkeit	re@@ ck@@ less@@ ness
ur@@ teile	jud@@ g@@ ments
ab@@ stam@@ mung	ance@@ stry
eigent@@ ü@@ mer	ow@@ ners
spek@@ tro@@ sk@@ op@@ ie	spec@@ tro@@ scop@@ y
zuge@@ hö@@ ri@@ gkeit	bel@@ on@@ ging
reser@@ v@@ at	reser@@ ve
hö@@ llen	h@@ ells
schwi@@ mmt	swi@@ mming
hirn@@ rin@@ de	cer@@ e@@ bra@@ l
apo@@ the@@ ke	pharma@@ cy
bl@@ auf@@ lossen@@ th@@ un@@ fisch	blu@@ ef@@ in
hü@@ f@@ ter@@ satz	re@@ plac@@ ement
stam@@ mes@@ gesellschaften	tri@@ b@@ al
wär@@ ter	gu@@ ards
aufgab@@ en@@ ver@@ la@@ gerung	shif@@ ting
flu@@ or@@ es@@ z@@ enz	flu@@ or@@ es@@ c@@ ence
vertrau@@ ens@@ wür@@ digkeit	tru@@ st@@ wor@@ thin@@ ess
hau@@ t@@ pig@@ men@@ ti@@ erung	pig@@ ment@@ ation
spr@@ ing@@ br@@ un@@ nen	foun@@ tain
fl@@ ö@@ ten@@ spieler	fl@@ ute
bu@@ tter@@ mil@@ ch	bu@@ tter@@ milk
mä@@ use	bucks
ambi@@ gu@@ ität	ambi@@ gu@@ ity
wasser@@ aff@@ en@@ theorie	a@@ qua@@ tic
rau@@ b@@ tiere	predat@@ ors
be@@ zeichnet	lab@@ el@@ ed
sau@@ ber@@ keit	cle@@ an@@ lin@@ ess
buch@@ haltung	accoun@@ ting
hö@@ l@@ zer@@ nen	woo@@ den
herausforder@@ nde	challen@@ ging
gehirn@@ wellen	bra@@ in@@ waves
a@@ sche	as@@ hes
auf@@ bau@@ studi@@ um	graduate
gegensei@@ tige	inter@@ depen@@ dence
lau@@ ten	l@@ oud
umwelt@@ schü@@ tz@@ er	environ@@ ment@@ alists
katastrop@@ hal@@ en	dis@@ a@@ str@@ ous
physi@@ ologische	physi@@ ological
augen@@ br@@ auen	e@@ ye@@ bro@@ ws
über@@ natürliche	super@@ natural
nutz@@ last	pay@@ load
technolog@@ isch	technologi@@ cally
n@@ ischen	ni@@ ches
unbe@@ gren@@ zte	un@@ limited
gel@@ as@@ sen@@ heit	ser@@ en@@ ity
aus@@ sicht	pro@@ spe@@ ct
nahrung	nutri@@ tion
gelegt	la@@ id
wieder@@ herstellung	re@@ stor@@ ation
luft@@ fahrt	a@@ vi@@ ation
umzu@@ setzen	imple@@ ment
beglei@@ ter	comp@@ ani@@ on
sonnen@@ blu@@ men	sun@@ flo@@ wers
eth@@ isch	eth@@ ically
st@@ eig@@ ung	slo@@ pe
ver@@ zö@@ gerung	del@@ ay
dom@@ esti@@ ziert	dom@@ esti@@ cated
verwal@@ ter	ste@@ wards
refle@@ kti@@ ert	refle@@ cted
ver@@ danken	o@@ we
gerei@@ st	travel@@ ing
ver@@ wurz@@ elt	ro@@ ot@@ ed
multi@@ pli@@ ziert	multi@@ pli@@ ed
ver@@ körper@@ n	em@@ body
kre@@ di@@ t@@ karten	cards
kün@@ di@@ gte	qu@@ it
ari@@ th@@ me@@ tik	ari@@ th@@ me@@ tic
üb@@ ungen	exer@@ cis@@ es
profi@@ tiert	benef@@ ited
zeichnet	dra@@ ws
hä@@ mo@@ glo@@ bin	he@@ mo@@ glo@@ bin
statisti@@ ker	statisti@@ cians
ge@@ eig@@ net	su@@ ited
über@@ bevölkerung	over@@ population
sozi@@ alismus	soci@@ alism
nutzung	sharing
as@@ sozi@@ ationen	associ@@ ations
an@@ kunft	arri@@ val
bestä@@ tigt	con@@ fir@@ med
wert@@ los	wor@@ th@@ less
be@@ trieben	powered
hei@@ zen	he@@ ating
haus@@ arbeit	hou@@ se@@ work
human@@ ismus	human@@ ism
medizin@@ isch	medi@@ cally
hoch@@ laden	u@@ plo@@ ad
be@@ qu@@ em@@ lichkeit	conven@@ i@@ ence
be@@ frie@@ digen	satis@@ fy
or@@ an@@ gen	or@@ an@@ ges
unter@@ welt	under@@ world
do@@ de@@ ka@@ e@@ der	do@@ deca@@ he@@ dr@@ on
versch@@ mel@@ zen	mer@@ ge
diplo@@ mati@@ schen	diplo@@ matic
cyber@@ waffen	cy@@ ber
entde@@ cker	explor@@ er
tier@@ welt	wild@@ life
hei@@ mat@@ land	hom@@ eland
rech@@ nung	calcu@@ lation
atmosp@@ hä@@ ren	atmosp@@ her@@ es
stra@@ hl	be@@ am
papi@@ er@@ kra@@ m	pa@@ per@@ work
anpas@@ s@@ ungs@@ fähigkeit	adap@@ t@@ ability
feuer@@ we@@ hr@@ männer	fire@@ men
geri@@ chte	dis@@ hes
verpflich@@ tet	ob@@ li@@ ged
ge@@ ja@@ gt	hun@@ ted
inter@@ agi@@ ert	inter@@ acts
aus@@ länder	foreig@@ ner
groß@@ v@@ ä@@ ter	grand@@ fa@@ thers
über@@ sehen	over@@ look
miss@@ verständnis	mis@@ understanding
sub@@ ven@@ tion@@ ieren	sub@@ si@@ di@@ ze
pri@@ va@@ ti@@ si@@ erung	pri@@ va@@ ti@@ zation
statt@@ gefunden	occur@@ red
fünf@@ tel	one-@@ fif@@ th
bes@@ ie@@ gt	de@@ fe@@ ated
schw@@ ein@@ eg@@ ri@@ ppe	s@@ wine
gei@@ mp@@ ft	vac@@ cin@@ ated
kol@@ oni@@ alismus	col@@ oni@@ alism
el@@ fen@@ bein@@ küste	i@@ vor@@ y
hä@@ up@@ t@@ linge	ch@@ ie@@ fs
bürger@@ lichen	ci@@ vi@@ c
sch@@ r@@ ank	clo@@ set
lö@@ s@@ bar	solu@@ ble
be@@ am@@ ten	offi@@ ci@@ als
echtz@@ eit	re@@ al-@@ time
f@@ alle	tra@@ p
fü@@ tter@@ t	fe@@ e@@ ds
mu@@ tige	bra@@ ve
dar@@ stellungen	repres@@ ent@@ ations
über@@ springen	ski@@ p
imm@@ un@@ ität	imm@@ unity
täu@@ schen	dec@@ ei@@ ve
schwä@@ chen	we@@ ak@@ n@@ esses
bei@@ ge@@ treten	jo@@ ined
lei@@ chtigkeit	e@@ ase
an@@ kommt	matters
hyper@@ bo@@ li@@ sche	hyper@@ bo@@ lic
di@@ chtern	po@@ ets
beschrän@@ kt	con@@ fin@@ ed
zu@@ geschrieben	at@@ tribu@@ ted
zwei@@ einhalb	two-@@ and-@@ a-@@ half
freund@@ schaften	friend@@ ships
po@@ lar@@ isi@@ erung	pol@@ ari@@ zation
sü@@ do@@ st@@ asien	sou@@ the@@ ast
ver@@ hun@@ gern	star@@ ve
flü@@ ge	fli@@ ghts
zeit@@ plan	sche@@ du@@ le
ge@@ ologische	ge@@ ological
ak@@ tion@@ äre	sh@@ are@@ hol@@ ders
kranken@@ wagen	am@@ bu@@ lan@@ ce
zahn@@ pa@@ st@@ a	to@@ o@@ th@@ pa@@ ste
ver@@ netz@@ ten	net@@ worked
ernä@@ hrt	fe@@ eding
mon@@ at@@ lichen	mon@@ th@@ ly
besitzen	ow@@ ning
bes@@ e@@ tzung	occu@@ pa@@ tion
fehl@@ barkeit	fal@@ li@@ bility
du@@ mm@@ heit	stu@@ pi@@ di@@ ty
notwen@@ digkeit	ne@@ c@@ essi@@ ty
vor@@ sicht	cau@@ tion
program@@ mier@@ bare	program@@ ma@@ ble
säu@@ le	plan@@ k
er@@ zieh@@ ung	up@@ bringing
um@@ stände	circum@@ stance
un@@ vollkommen	im@@ perfect
ei@@ fer@@ sü@@ chti@@ g	je@@ al@@ ous
psych@@ ische	psychiat@@ ric
ges@@ pal@@ ten@@ e	spli@@ t
be@@ förder@@ ung	pro@@ motion
konta@@ kte	cont@@ acts
voll@@ zeit	ful@@ l-@@ time
drei@@ jährigen	three-@@ year-old
sü@@ ße	swe@@ et@@ ness
war@@ tet	wa@@ its
fru@@ cht@@ barkeit	ferti@@ li@@ ty
ge@@ tr@@ än@@ ke	drin@@ ks
angeneh@@ mer	enjo@@ y@@ able
verständlich	under@@ stand@@ able
st@@ res@@ si@@ g	st@@ res@@ s@@ ful
um@@ sätze	re@@ ven@@ u@@ es
be@@ fr@@ eit	liber@@ ated
metaph@@ or@@ isch	metaph@@ or@@ ically
hy@@ dr@@ anten	hy@@ dr@@ ant
sch@@ rein	s@@ hr@@ ine
ide@@ ologi@@ en	ide@@ ologi@@ es
moder@@ nis@@ mus	moder@@ nis@@ m
vor@@ über@@ geh@@ end	tempor@@ arily
zurück@@ le@@ hnen	rec@@ line
kü@@ chen	kit@@ ch@@ ens
bei@@ ßen	bi@@ te
geogra@@ fische	geogra@@ phi@@ cal
kreu@@ zung	inter@@ section
näher@@ n	approach@@ ing
ver@@ blei@@ ben@@ den	rema@@ ining
tr@@ ö@@ pf@@ chen@@ be@@ wä@@ s@@ ser@@ ung	dri@@ p
jahr@@ taus@@ ends	mil@@ len@@ ni@@ um
un@@ gleich@@ heiten	ine@@ quali@@ ties
vorzu@@ gs@@ weise	pre@@ fer@@ ably
arbeit@@ geber	emplo@@ yers
schwi@@ mmer	swi@@ mmer
nahrungs@@ suche	for@@ aging
enga@@ gi@@ ert	enga@@ ged
schlag	b@@ low
wieder@@ hergestellt	re@@ stor@@ ed
er@@ leiden	suff@@ er
lebens@@ veränder@@ nden	life@@ -@@ changing
geschie@@ den	di@@ vor@@ ced
ei@@ tel@@ keit	van@@ ity
fle@@ cken	spo@@ ts
versu@@ chs@@ kan@@ in@@ chen	gu@@ ine@@ a
schwi@@ m@@ men@@ de	flo@@ ating
ent@@ führung	kid@@ na@@ pping
mis@@ ser@@ folge	fail@@ ures
äl@@ teren	el@@ ders
dis@@ son@@ anz	dis@@ son@@ ance
selbst@@ diszi@@ pli@@ n	self-@@ discipl@@ ine
gilt	app@@ lies
herunter@@ geladen	down@@ lo@@ aded
mu@@ ko@@ vis@@ zi@@ do@@ se	cy@@ stic
hü@@ gel	bu@@ mp
simu@@ li@@ erten	simul@@ ated
neben@@ produkt	by@@ product
steu@@ er@@ zahl@@ er	tax@@ pa@@ yer
freu@@ den	jo@@ ys
destru@@ ktiv	de@@ struc@@ tive
blut@@ ver@@ gi@@ e@@ ßen	b@@ loo@@ d@@ shed
unter@@ mau@@ ert	under@@ p@@ ins
evolution@@ ä@@ r	evolution@@ arily
veröffent@@ lich@@ ung	publi@@ cation
ab@@ stimmung	vot@@ ing
ver@@ d@@ auen	di@@ gest
kul@@ tivi@@ eren	cul@@ tiv@@ ate
train@@ iert	co@@ ach@@ ed
ver@@ drän@@ gung	den@@ ial
analy@@ tische	analy@@ tical
brei@@ ten	bro@@ ad
fre@@ un@@ din@@ nen	gir@@ l@@ friends
klo@@ pf@@ te	kno@@ cked
dor@@ f@@ be@@ wohner	villa@@ gers
univer@@ s@@ alität	univer@@ s@@ ality
staat@@ s@@ führung	govern@@ ance
er@@ ober@@ ung	con@@ qu@@ est
arbeits@@ moral	eth@@ ic
standar@@ dis@@ ierte	standar@@ di@@ zed
ab@@ sei@@ l@@ fa@@ den	dra@@ gl@@ ine
sei@@ den@@ drü@@ sen	gl@@ ands
klas@@ si@@ fi@@ kation	classi@@ fication
an@@ gele@@ gen@@ heiten	aff@@ air@@ s
ani@@ mieren	anima@@ te
len@@ ken	ste@@ er
leiden@@ schaft@@ lich	passion@@ ately
veränderte	alter@@ ed
atmosp@@ här@@ ische	atmosp@@ her@@ ic
vul@@ kan@@ ischen	vol@@ can@@ ic
be@@ wo@@ hnen	in@@ hab@@ it
hand@@ schriften	man@@ us@@ cri@@ p@@ ts
ge@@ wa@@ schen	was@@ hed
milli@@ gramm	milli@@ gra@@ ms
wander@@ n	migra@@ te
dau@@ erte	la@@ sted
ließ	dro@@ pped
brü@@ ste	brea@@ sts
kohlen@@ stoff@@ nan@@ or@@ ö@@ hren	nan@@ ot@@ u@@ bes
vor@@ spiel	fore@@ play
leb@@ haft	vi@@ vi@@ dly
er@@ schließen	un@@ lock
ausge@@ glichen	bal@@ an@@ ced
um@@ fas@@ sende	com@@ pre@@ hen@@ sive
zusammen@@ zubringen	bringing
bekann@@ ter@@ weise	fam@@ ously
erfin@@ dern	inv@@ ent@@ ors
vor@@ fahr	ance@@ st@@ or
fanden	finding
imag@@ in@@ äre	imag@@ in@@ ary
ver@@ he@@ erenden	de@@ va@@ stat@@ ing
argu@@ men@@ tierte	argu@@ ed
jä@@ ger	h@@ unter@@ s
tür@@ k@@ ischen	tur@@ k@@ ish
be@@ stre@@ b@@ ungen	as@@ pi@@ ra@@ tions
mach@@ bar	fe@@ asi@@ ble
islam@@ ismus	islam@@ ism
fle@@ chten	lich@@ ens
zeugen	wit@@ n@@ esses
karri@@ eren	care@@ ers
kan@@ ari@@ en@@ vo@@ gel	can@@ ary
greif@@ bar	tan@@ gi@@ ble
pen@@ deln	com@@ mu@@ te
ver@@ zer@@ r@@ ung	di@@ stor@@ tion
über@@ schü@@ ssi@@ ge	ex@@ cess
industri@@ alisierung	industri@@ alization
dis@@ si@@ denten	dis@@ si@@ dents
bau@@ stellen	sites
draußen	out@@ do@@ ors
schul@@ geld	fe@@ es
p@@ ein@@ lichkeit	embar@@ ras@@ s@@ ment
mikro@@ proz@@ ess@@ oren	micro@@ process@@ ors
effe@@ k@@ tivität	effec@@ ti@@ ven@@ ess
berg@@ auf	u@@ ph@@ ill
kauf@@ te	buying
stie@@ fel	bo@@ ots
enth@@ ü@@ ll@@ ungen	re@@ vel@@ ations
bahn@@ brech@@ ende	gro@@ und@@ breaking
se@@ hn@@ sucht	ye@@ ar@@ ning
ad@@ oles@@ z@@ enz	ad@@ oles@@ c@@ ence
bevölk@@ ert	popul@@ ated
the@@ ologie	the@@ ology
grei@@ ft	reach@@ es
aus@@ gerü@@ stet	equi@@ pped
er@@ freu@@ t	pleas@@ ed
be@@ tt@@ eln	beg@@ ging
pro@@ ji@@ ziert	proje@@ cted
ex@@ por@@ tiert	ex@@ por@@ ted
augen@@ blick@@ lich	inst@@ antly
kü@@ chen@@ kre@@ p@@ p	to@@ we@@ l
krä@@ he	cro@@ w
kab@@ in@@ et@@ t	cab@@ in@@ et
spo@@ tt@@ dro@@ s@@ seln	mo@@ ck@@ ing@@ birds
em@@ pf@@ än@@ g@@ nis	con@@ ception
organis@@ at@@ oren	organi@@ z@@ ers
se@@ chs@@ jährigen	si@@ x-@@ year-old
bewer@@ tungen	rat@@ ings
vor@@ herr@@ sch@@ ende	pre@@ vail@@ ing
ver@@ schle@@ ppt	traff@@ i@@ cked
tö@@ dliche	le@@ th@@ al
her@@ stell@@ ern	manufac@@ tur@@ ers
tex@@ tili@@ en	tex@@ ti@@ les
lö@@ we	li@@ on
se@@ est@@ ern	star@@ fish
ver@@ tre@@ ter	repres@@ ent@@ a@@ tives
aus@@ geschlossen	ex@@ clu@@ ded
tex@@ ti@@ lin@@ du@@ str@@ ie	tex@@ ti@@ le
opti@@ k	op@@ tics
unter@@ drück@@ ten	op@@ pres@@ sed
feu@@ cht@@ gebiete	we@@ t@@ lands
un@@ moral@@ isch	im@@ moral
versch@@ lu@@ ckt	s@@ wal@@ lo@@ wed
trä@@ um@@ te	dre@@ am@@ ed
bes@@ at@@ zung	cre@@ w
ein@@ gesch@@ rän@@ kt	restri@@ cted
erhö@@ h@@ ten	el@@ ev@@ ated
feuer@@ holz	fire@@ wood
wen@@ dung	twi@@ st
verb@@ un@@ den@@ heit	connec@@ te@@ dness
sozial@@ arbeiter	wor@@ ker
ent@@ täusch@@ end	dis@@ ap@@ poin@@ ting
über@@ lebens	survival
wunder@@ te	wondering
unter@@ tas@@ sen	sau@@ cers
wa@@ sch@@ mittel	deter@@ gent
an@@ näher@@ ung	appro@@ x@@ ima@@ tion
be@@ tritt	en@@ ters
kü@@ hlt	co@@ ols
kop@@ f-@@ zahl@@ -@@ kopf	head@@ -@@ ta@@ il@@ -@@ head
ste@@ cker	plu@@ g
auto@@ mati@@ si@@ erung	auto@@ ma@@ tion
ton@@ höhe	pit@@ ch
log@@ ari@@ th@@ mischen	log@@ ari@@ th@@ mic
ge@@ stän@@ dnis	conf@@ ession
versu@@ chs@@ leiter	experim@@ enter
halb	hal@@ f@@ way
umge@@ bende	surro@@ unding
zu@@ kun@@ f@@ ts@@ form	fu@@ tur@@ eless
darstellen	pose
fanta@@ stische	fab@@ ul@@ ous
schwä@@ cher	we@@ ak@@ er
fuß@@ ab@@ drü@@ cke	foot@@ prin@@ ts
moder@@ n@@ isi@@ erung	moder@@ ni@@ zation
a@@ ero@@ dynam@@ ischen	a@@ ero@@ dynamic
ko@@ st@@ eng@@ ün@@ stige	low-@@ cost
sym@@ ph@@ on@@ ien	sym@@ ph@@ on@@ ies
gä@@ hnen	y@@ a@@ wn
wein@@ trau@@ ben	gra@@ pes
entschei@@ dungs@@ fin@@ dung	decisi@@ on-@@ making
radi@@ o@@ ak@@ tive	radi@@ o@@ active
begren@@ zung	boundar@@ y
be@@ festi@@ gen	atta@@ ch
über@@ trei@@ bung	hyper@@ bo@@ le
unterstü@@ tz@@ er	suppor@@ ters
zu@@ las@@ sung	appro@@ val
experim@@ enti@@ erte	experim@@ ented
ar@@ ro@@ ganz	ar@@ ro@@ gan@@ ce
chem@@ isch	chemi@@ cally
repli@@ kation	repli@@ cation
er@@ langen	gain
schul@@ ab@@ bre@@ cher	dro@@ po@@ ut
acht@@ samkeit	awareness
vor@@ arbeiter	fore@@ man
be@@ frie@@ di@@ gend	satis@@ fying
bau@@ unternehmer	develop@@ er
ernsthaf@@ tigkeit	seri@@ ousness
ka@@ v@@ aller@@ ie	ca@@ val@@ ry
wer@@ ben	adverti@@ se
ob@@ da@@ ch@@ lo@@ sigkeit	hom@@ el@@ ess@@ ness
ku@@ chen@@ verk@@ auf	ba@@ ke
zuschau@@ er	vie@@ wers
vor@@ städte	sub@@ ur@@ bia
lebens@@ mittel@@ geschäft	gro@@ cer@@ y
bewer@@ ten	grade
ei@@ er@@ stock@@ krebs	o@@ vari@@ an
nieder@@ schlag	rain@@ fall
roll@@ en@@ spiele	ro@@ le-@@ play
fix@@ iert	fix@@ ed
kommuni@@ ziert	communic@@ ates
au@@ ster	o@@ y@@ ster
be@@ arbeiten	ed@@ it
auf@@ blü@@ hen	fl@@ our@@ ishing
hand@@ wer@@ ker	cra@@ f@@ ts@@ men
the@@ ke	counter
gew@@ and	ro@@ be
waff@@ en@@ ru@@ he	tru@@ ce
inter@@ fer@@ enz@@ muster	inter@@ ference
brenn@@ weite	fo@@ cal
schwa@@ ger	bro@@ ther@@ -@@ in-@@ law
ent@@ sprechen	cor@@ respond
bö@@ gen	bo@@ ws
alli@@ an@@ zen	alli@@ an@@ ces
ver@@ däch@@ tigen	sus@@ pe@@ cts
süd@@ west	sou@@ th@@ west
ge@@ brau@@ chs@@ waren	com@@ modi@@ ties
an@@ organ@@ ische	in@@ organic
sonnen@@ ähn@@ lichen	sun@@ -@@ like
musi@@ ker@@ in	musi@@ cian
stra@@ ft@@ ä@@ ter	offen@@ ders
berichten	co@@ vering
stimm@@ z@@ et@@ tel	bal@@ lot
for@@ st@@ wirtschaft	fore@@ stry
scha@@ den@@ s@@ begren@@ zung	har@@ m
körper@@ größe	hei@@ ght
s@@ no@@ bis@@ mus	s@@ no@@ b@@ ber@@ y
zufä@@ lli@@ gkeit	rand@@ om@@ ness
ne@@ kro@@ phil@@ ie	ne@@ cro@@ phili@@ a
kon@@ stell@@ ationen	con@@ stell@@ ations
dra@@ chen	ki@@ te
fälle	in@@ stances
hän@@ d@@ ler	tra@@ ders
läu@@ fer	run@@ ners
kan@@ ni@@ b@@ alen	can@@ ni@@ b@@ als
aus@@ zeit	s@@ ab@@ ba@@ tical
dar@@ stell@@ enden	per@@ forming
homo@@ ehen	sam@@ e-@@ sex
mehr@@ hei@@ tlich	musli@@ m-@@ majority
mon@@ at@@ s@@ bin@@ den	san@@ it@@ ary
unter@@ bewusst	sub@@ conscious
kor@@ reli@@ erte	cor@@ rel@@ ate
selbst@@ trans@@ zen@@ den@@ z	self-@@ tran@@ scen@@ dence
brau@@ er@@ ei@@ en	bre@@ wers
ab@@ kommen@@ bas@@ ierte	treat@@ y-@@ based
mikro@@ -@@ maschinen	micro@@ -@@ machines
treiben	dri@@ ft
proto@@ kol@@ l	proto@@ co@@ l
ab@@ wasser	se@@ wa@@ ge
gat@@ tung	gen@@ us
ver@@ schi@@ fft	shi@@ pped
at@@ met	brea@@ th@@ es
sonnen@@ auf@@ gang	sun@@ rise
schnell@@ sten	fa@@ ste@@ st-@@ growing
sing@@ ul@@ ar@@ ität	sing@@ ul@@ ar@@ ity
außergewöhn@@ lich	ex@@ cep@@ tional
häus@@ liche	dom@@ esti@@ c
arbei@@ ter@@ klasse	work@@ ing-@@ class
g@@ är@@ t@@ nern	gar@@ den@@ ing
über@@ see	over@@ se@@ as
wahr@@ nimmt	percei@@ ves
ide@@ al@@ fall	ide@@ ally
schwan@@ ger@@ schaften	preg@@ nan@@ cies
tä@@ ter	per@@ pe@@ tr@@ ators
organ@@ isch	organ@@ ically
erd@@ be@@ eren	stra@@ w@@ ber@@ ries
de@@ fi@@ z@@ it	de@@ fic@@ it
masch@@ in@@ er@@ ie	machin@@ ery
ger@@ issen	ri@@ pped
lim@@ b@@ ischen	lim@@ bi@@ c
p@@ fü@@ tze	pu@@ dd@@ le
empfin@@ dung	sen@@ sation
elektro@@ chem@@ ische	electro@@ chemical
zer@@ em@@ on@@ ien	cer@@ em@@ on@@ ies
predi@@ ger	pre@@ a@@ cher
unge@@ heu@@ er	hu@@ gely
setzt	sets
diszi@@ pl@@ in@@ iert	discipl@@ ined
pil@@ ger@@ reise	pil@@ gri@@ ma@@ ge
ein@@ schlafen	as@@ le@@ ep
bö@@ den	so@@ ils
über@@ do@@ sis	over@@ do@@ se
un@@ voll@@ stän@@ dige	in@@ complete
überprü@@ ft	che@@ cked
todes@@ raten	rates
blü@@ te	blo@@ om
wiesen	me@@ a@@ do@@ ws
roll@@ tre@@ ppen	es@@ cal@@ ators
optimi@@ ert	optimi@@ zed
rein@@ heit	pu@@ ri@@ ty
furcht@@ los	fe@@ ar@@ less
zusammen@@ gesetzt	com@@ posed
gab@@ el	for@@ k
selts@@ amer@@ weise	o@@ dd@@ ly
er@@ mäch@@ tigt	em@@ powered
pers@@ ischen	per@@ si@@ an
ma@@ ku@@ la@@ de@@ generation	ma@@ cular
be@@ un@@ ruhi@@ gend	dist@@ ur@@ bing
ab@@ gelei@@ tet	der@@ i@@ ved
neuro@@ lo@@ ge	neuro@@ log@@ ist
zwei@@ fel@@ los	und@@ ou@@ b@@ ted@@ ly
bekannte	well-@@ known
genau@@ e	accu@@ rate
wen@@ dungen	twi@@ sts
beru@@ f@@ lich	profession@@ ally
alp@@ hab@@ e@@ ti@@ si@@ erung	liter@@ acy
abzu@@ le@@ hnen	re@@ je@@ ct
büro@@ kra@@ tische	bu@@ re@@ au@@ cra@@ tic
blog@@ gern	blog@@ gers
aus@@ reich@@ end	suff@@ i@@ cient
auf@@ s	coun@@ tr@@ y@@ side
trau@@ mati@@ schen	trau@@ matic
un@@ erwartet	un@@ expec@@ ted@@ ly
verstän@@ d@@ licherweise	under@@ stand@@ ably
ver@@ braucht	consu@@ mes
pra@@ g@@ mati@@ schen	pra@@ g@@ matic
er@@ wer@@ b	ac@@ qu@@ isi@@ tion
hing@@ ab@@ e	de@@ dic@@ ation
um@@ fang	scop@@ e
schwä@@ ch@@ sten	we@@ ak@@ est
bro@@ schü@@ re	bro@@ ch@@ ure
versch@@ rieben	pres@@ cri@@ bed
pl@@ ei@@ te	b@@ ust
kli@@ ckte	cli@@ cked
se@@ ch@@ st@@ kl@@ ä@@ ss@@ ler	six@@ th-@@ gra@@ ders
ta@@ schen@@ geld	allo@@ wan@@ ce
symbo@@ li@@ siert	symbo@@ li@@ zes
im@@ por@@ tieren	im@@ por@@ ting
bei@@ trägt	contribu@@ tes
aufge@@ li@@ stet	li@@ sted
sich@@ ere	sec@@ ure
rech@@ nern	calcul@@ ators
zwei@@ st@@ elli@@ ge	two-@@ dig@@ it
la@@ ger@@ raum	stor@@ age
h@@ of	cour@@ ty@@ ard
rei@@ ß@@ zä@@ hne	fan@@ gs
bürger@@ stei@@ ge	si@@ de@@ wal@@ ks
über@@ flu@@ tungen	f@@ loo@@ ding
19@@ 20@@ ern	19@@ 20@@ s
gener@@ iert	gener@@ ated
mittel@@ klasse	midd@@ le-@@ class
se@@ gel@@ te	sa@@ iled
ein@@ wander@@ ung	im@@ migra@@ tion
anzu@@ greifen	attac@@ king
krei@@ s@@ förmi@@ ge	cir@@ cular
wirk@@ samkeit	eff@@ ic@@ acy
herr@@ sch@@ enden	rul@@ ing
im@@ peri@@ alismus	im@@ peri@@ alism
algorith@@ m@@ ische	algorith@@ mic
vor@@ geschlagen	suggest@@ ed
besch@@ werte	com@@ pla@@ ined
metaph@@ or@@ ische	metaph@@ or@@ ical
la@@ ger@@ haus	war@@ e@@ house
auf@@ er@@ ste@@ hung	res@@ ur@@ rec@@ tion
f@@ arb@@ stoff	dy@@ e
gegen@@ stände	it@@ em@@ s
besch@@ ul@@ digt	acc@@ used
kr@@ äu@@ ter	her@@ bs
an@@ trieb	pro@@ pul@@ sion
ge@@ graben	du@@ g
prakti@@ ziert	practic@@ ed
akzep@@ tab@@ el	accep@@ table
tun@@ es@@ ischen	tun@@ isi@@ an
sitz@@ ungen	s@@ essi@@ ons
kon@@ si@@ stenz	consi@@ sten@@ cy
selbst@@ täusch@@ ung	self-@@ de@@ ception
lau@@ ert	l@@ ur@@ king
geld@@ wä@@ sche	la@@ under@@ ing
pr@@ äch@@ tige	gl@@ ori@@ ous
schul@@ leiter	princi@@ p@@ al
spit@@ z@@ namen	ni@@ ck@@ name
bom@@ bar@@ diert	bom@@ bar@@ ded
ver@@ las@@ sen@@ en	ab@@ and@@ oned
fä@@ hre	fer@@ ry
beziehen	rel@@ ate
blo@@ g-@@ ein@@ träge	po@@ sts
post@@ trau@@ mati@@ sche	post-@@ trau@@ matic
revolution@@ iert	revolution@@ i@@ zed
sp@@ här@@ ische	sp@@ her@@ ical
weite	va@@ st@@ ness
au@@ gä@@ p@@ fel	e@@ ye@@ ball@@ s
n@@ eig@@ ung	pro@@ pen@@ sity
forsch@@ ung@@ ser@@ geb@@ nisse	fin@@ dings
ha@@ ar@@ schnitt	ha@@ ir@@ cut
nutz@@ bar	har@@ ness
untersucht	exam@@ ines
ab@@ sichtlich	deli@@ ber@@ ately
ben@@ ei@@ den	en@@ vy
verwir@@ ren	conf@@ use
sch@@ wär@@ me	s@@ war@@ ms
syn@@ chron@@ isi@@ ert	syn@@ chr@@ oni@@ zed
ein@@ fri@@ eren	free@@ ze
spiegel@@ t	refle@@ cts
raum@@ fahr@@ zeuge	spac@@ ec@@ raft
hoch@@ entwickelte	sophisti@@ cated
konzent@@ ra@@ tionen	concent@@ ra@@ tions
interak@@ tiv	inter@@ ac@@ tively
ver@@ stü@@ mm@@ elt	mu@@ ti@@ l@@ ated
decken	blan@@ ke@@ ts
re@@ konstru@@ ierte	re@@ constru@@ cted
aus@@ brei@@ tet	spre@@ ading
auf@@ geb@@ lä@@ ht	blo@@ ated
anzu@@ wenden	appl@@ ying
vorher@@ sehen	anti@@ ci@@ pa@@ te
selb@@ sta@@ chtung	self-@@ e@@ ste@@ em
besch@@ i@@ chtung	co@@ ating
ab@@ gesch@@ la@@ chtet	s@@ laugh@@ ter@@ ed
psycho@@ therapie	psycho@@ therapy
kom@@ pe@@ tent	compe@@ tent
trauri@@ gste	sa@@ d@@ dest
ver@@ führt	se@@ duced
sch@@ äd@@ linge	pe@@ sts
se@@ chs@@ einhalb	si@@ x-@@ and-@@ a-@@ half
su@@ chan@@ fragen	sear@@ ches
geschäfts@@ mann	busin@@ ess@@ man
an@@ ag@@ ra@@ mme	an@@ ag@@ ra@@ ms
über@@ flu@@ tet	f@@ loo@@ ded
sozi@@ ologe	soci@@ ologist
steu@@ er@@ ru@@ der	ru@@ d@@ der
se@@ geln	sa@@ il@@ ing
fes@@ sel@@ n@@ d	comp@@ elling
strei@@ ti@@ gkeiten	dis@@ pu@@ tes
mü@@ l@@ lei@@ mer	tr@@ ash
wieder@@ zu@@ entdecken	re@@ discover
arm@@ band@@ uhr	wri@@ st@@ watch
brü@@ ten	bre@@ ed
rück@@ gän@@ gi@@ g	un@@ do
ka@@ is@@ er	em@@ per@@ or
besch@@ ü@@ tzen	prote@@ cting
frag@@ wür@@ dig	questi@@ on@@ able
schn@@ ab@@ el	be@@ ak
as@@ er@@ ba@@ i@@ d@@ sch@@ an	a@@ zer@@ ba@@ i@@ j@@ an
auf@@ stände	in@@ sur@@ gen@@ cy
paki@@ stan@@ ische	paki@@ stan@@ i
lang@@ le@@ bi@@ gen	long-@@ lived
freiwilli@@ ge	volun@@ t@@ ary
leiten	condu@@ ct
freund@@ licherweise	kin@@ dly
unter@@ lei@@ b	ab@@ d@@ omen
ver@@ sau@@ erung	aci@@ di@@ fication
fr@@ ö@@ h@@ lich	happ@@ ily
cal@@ ci@@ um@@ car@@ bon@@ at	car@@ bon@@ ate
kr@@ ü@@ mm@@ ungen	war@@ ps
physi@@ kern	physi@@ ci@@ sts
betrachtet	vie@@ wed
ge@@ fil@@ tert	fil@@ ter@@ ed
ange@@ wiesen	rely
mobili@@ si@@ erung	mobili@@ zation
palä@@ on@@ t@@ ologen	pal@@ e@@ on@@ t@@ ologists
sche	dar@@ win@@ ian
beru@@ hi@@ gend	com@@ for@@ ting
konser@@ viert	preser@@ ved
be@@ frie@@ digung	gra@@ ti@@ fication
ver@@ ber@@ gen	hi@@ ding
schreib@@ tische	des@@ ks
spa@@ zier@@ gän@@ ge	wal@@ ks
gemeinde	con@@ gre@@ gation
trau@@ ern	m@@ our@@ n
zu@@ ver@@ lässi@@ gkeit	reli@@ ability
materi@@ alismus	materi@@ alism
ent@@ fal@@ tet	un@@ fol@@ ds
werk@@ zeug@@ ka@@ sten	to@@ ol@@ box
be@@ stür@@ zt	up@@ set
pe@@ tro@@ chemikalien	pe@@ tro@@ chemicals
kit@@ z@@ eln	ti@@ ck@@ le
mu@@ sch@@ el	cla@@ m
flug@@ gerät	air@@ craft
an@@ geschlossen	pl@@ ug@@ ged
ge@@ trieben	pus@@ hed
brilli@@ anz	brilli@@ ance
feu@@ ern	fir@@ ing
geld@@ herr@@ schaft	plu@@ to@@ cra@@ cy
un@@ berührt	un@@ tou@@ ched
erd@@ ähnliche	planets
hal@@ bin@@ sel	pen@@ insu@@ la
zu@@ gegeben	ad@@ mit@@ ted@@ ly
schen@@ ken	paying
über@@ mäß@@ ige	exc@@ essi@@ ve
ko@@ ordin@@ iert	co@@ ordin@@ ated
zu@@ cker@@ brot	car@@ ro@@ ts
bei@@ träge	contribu@@ tions
besch@@ werde	com@@ pla@@ int
arm@@ b@@ än@@ der	bra@@ cele@@ ts
wör@@ t@@ liche	liter@@ al
rau@@ pen	cat@@ er@@ p@@ ill@@ ars
hei@@ ß@@ e@@ sten	hot@@ test
sch@@ er@@ z	kid@@ ding
virtu@@ alität	virtu@@ ality
arch@@ ä@@ ologen	ar@@ che@@ ologists
tü@@ te	bag
raum@@ bühne	thr@@ ust
zu@@ genommen	ga@@ ined
kü@@ ssen	k@@ is@@ sing
erzähl@@ er	nar@@ r@@ ator
visu@@ alisi@@ erungen	visu@@ ali@@ zations
de@@ mü@@ tigung	hu@@ mili@@ ation
beteili@@ gung	invol@@ vement
dru@@ ckt	prin@@ ts
bot@@ anischen	bot@@ an@@ ical
per@@ kus@@ sion	per@@ c@@ us@@ sion
wä@@ hlte	picked
ent@@ täu@@ schen	dis@@ ap@@ point
herz@@ -@@ krei@@ s@@ lauf@@ -@@ erkrank@@ ungen	car@@ dio@@ vas@@ cular
frie@@ dlich	pe@@ ac@@ efully
in@@ toler@@ anz	in@@ toler@@ ance
ver@@ spiel@@ theit	play@@ ful@@ ness
gegensei@@ tig	mu@@ tu@@ ally
ma@@ cht@@ los	power@@ less
üb@@ eln	ev@@ ils
gren@@ zen@@ los	limit@@ less
re@@ k@@ ru@@ tiert	rec@@ ru@@ ited
indi@@ kat@@ oren	indi@@ cat@@ ors
ver@@ trieben	dis@@ placed
ein@@ kommen@@ s@@ sch@@ wachen	low-@@ income
hand@@ werk@@ sk@@ un@@ st	cra@@ f@@ ts@@ man@@ ship
sinn@@ lichkeit	sen@@ su@@ ality
ein@@ drü@@ cke	impres@@ sions
überzeu@@ gende	convin@@ cing
gleich@@ gü@@ l@@ tigkeit	in@@ difference
hoff@@ nungs@@ lo@@ sigkeit	hop@@ el@@ ess@@ ness
fei@@ ert	cele@@ br@@ ates
ta@@ schen@@ lam@@ pe	flas@@ h@@ light
human@@ i@@ stische	human@@ i@@ stic
auf@@ führen	per@@ form
o@@ s@@ man@@ ischen	ot@@ to@@ man
wieder@@ geburt	re@@ birth
flu@@ or@@ es@@ zier@@ endes	flu@@ or@@ es@@ cent
verein@@ bar@@ ungen	agre@@ ements
frieden@@ stru@@ ppen	pe@@ ac@@ e@@ kee@@ pers
um@@ setzung	imple@@ ment@@ ation
o@@ dy@@ s@@ see	o@@ dy@@ s@@ sey
augen@@ bin@@ de	blin@@ d@@ fold
frie@@ d@@ h@@ of	ce@@ me@@ tery
verb@@ ie@@ ten	ban
er@@ schreck@@ end	terri@@ fying
ab@@ stimmen	vote
mon@@ tiert	moun@@ ted
i@@ kon@@ ische	i@@ con@@ ic
du@@ schen	sho@@ wers
über@@ trag@@ bare	communic@@ able
unter@@ bewusstsein	un@@ conscious
hand@@ tasche	hand@@ bag
vorberei@@ ten	prepar@@ ing
li@@ ss@@ ab@@ on	li@@ s@@ b@@ on
kon@@ ver@@ tiert	conver@@ ted
besu@@ che	vis@@ its
eth@@ ni@@ zität	eth@@ ni@@ city
ver@@ brenn@@ ungs@@ motor	com@@ bu@@ sti@@ on
aufge@@ führt	per@@ formed
zer@@ ti@@ fiziert	cer@@ ti@@ fied
gigan@@ tischen	gigan@@ tic
gewe@@ ben	tis@@ su@@ es
diagno@@ stischen	diagno@@ stic
labor@@ at@@ orien	labor@@ at@@ ories
geb@@ a@@ det	ba@@ th@@ ed
ant@@ arkti@@ schen	ant@@ arc@@ tic
staat@@ sk@@ asse	tre@@ as@@ ury
ent@@ be@@ hr@@ ung	de@@ pri@@ vation
kreu@@ ze	cros@@ ses
aus@@ ru@@ fe@@ zeichen	exc@@ la@@ ma@@ tion
über@@ schrei@@ ten	tran@@ sc@@ end
g@@ ast	gu@@ est
ver@@ hand@@ lung	negoti@@ ation
ker@@ am@@ ik	cer@@ am@@ ics
rein@@ i@@ gt	cle@@ ans
zielen	a@@ im
lei@@ chten	s@@ light
enth@@ ü@@ ll@@ ung	un@@ v@@ ei@@ ling
ver@@ stre@@ ut	sc@@ at@@ ter@@ ed
w@@ ö@@ ch@@ entlich	wee@@ k@@ ly
sta@@ un@@ en	mar@@ vel
verpflich@@ tungen	ob@@ li@@ ga@@ tions
ab@@ sto@@ ß@@ ende	re@@ pul@@ sive
lebens@@ wichtig	vi@@ tal
mikro@@ welt	mi@@ cr@@ o
un@@ geschü@@ tz@@ ten	un@@ prote@@ cted
rau@@ b	rob@@ ber@@ y
gei@@ st@@ es@@ wissenschaften	human@@ i@@ ties
lin@@ ear@@ ität	lin@@ ear@@ ity
schei@@ ch	sh@@ ei@@ k@@ h
gemein@@ nütz@@ igen	non-@@ profit
imp@@ fen	vac@@ cin@@ ate
einsatz	operation
se@@ k@@ und@@ äre	secon@@ dar@@ y
bü@@ ff@@ el	bu@@ ff@@ al@@ o
un@@ denk@@ bare	un@@ thin@@ k@@ able
dro@@ hne	dr@@ one
modi@@ fiziert	modi@@ fied
vor@@ ein@@ genommen	bi@@ ased
le@@ genden	le@@ gen@@ ds
zentr@@ alisi@@ erten	cent@@ r@@ alized
itali@@ en@@ er	itali@@ ans
bit@@ teren	bit@@ ter
bürger@@ schaft	citi@@ zen@@ ship
fei@@ er@@ lichkeiten	celebra@@ tions
gel@@ äch@@ ter	lau@@ ghter
gere@@ cht@@ fer@@ tigt	justi@@ fied
k@@ amer@@ am@@ ann	c@@ amer@@ a@@ man
plasti@@ k@@ tü@@ ten	bag@@ s
mur@@ m@@ eln	mar@@ bles
ein@@ bahn@@ straße	one-@@ way
krei@@ s@@ verkehr	ro@@ und@@ about
we@@ ht	blo@@ ws
be@@ wunder@@ te	ad@@ mi@@ red
stau@@ b@@ sau@@ ger	cle@@ an@@ ers
se@@ gel@@ boot	sa@@ il@@ boat
tro@@ tzen	de@@ fy
ro@@ hö@@ l	cru@@ de
tur@@ ing@@ test	turing
sicherheits@@ gur@@ te	se@@ at@@ bel@@ ts
extre@@ mi@@ stischen	extrem@@ ist
un@@ beha@@ gen	dis@@ comfort
er@@ schöpf@@ ung	ex@@ hau@@ sti@@ on
g@@ le@@ tsch@@ ers	gl@@ aci@@ er
kop@@ f-@@ zahl@@ -@@ zahl	head@@ -@@ ta@@ il@@ -@@ tail
beru@@ fung	appe@@ al
koll@@ ab@@ iert	collap@@ ses
de@@ mor@@ alisiert	de@@ mor@@ alized
sy@@ ner@@ gie	sy@@ ner@@ g@@ y
fehl@@ geburt	mis@@ car@@ ri@@ age
sum@@ men	su@@ ms
end@@ los	end@@ less@@ ly
leg@@ as@@ th@@ en@@ i@@ ker	dy@@ sle@@ x@@ ic
ken@@ i@@ anischen	ken@@ y@@ an
str@@ eit	fi@@ ghts
psychop@@ ath@@ ischen	psychop@@ ath@@ ic
psychop@@ a@@ then	psychop@@ a@@ ths
me@@ da@@ ille	me@@ d@@ al
großartig	terri@@ fic
bildungs@@ system	edu@@ cational
stell@@ ver@@ tre@@ ter	pro@@ x@@ y
chron@@ isch	chron@@ ically
dre@@ h@@ moment	tor@@ que
behand@@ el@@ bar	treat@@ able
ver@@ ges@@ sen@@ en	for@@ gotten
vor@@ schau	pre@@ view
sub@@ kultur	sub@@ culture
un@@ regel@@ mäß@@ igen	ir@@ regular
theore@@ tiker	theor@@ ist
spei@@ ch@@ ert	stor@@ es
le@@ xi@@ k@@ ogra@@ fie	le@@ xi@@ co@@ graph@@ y
sy@@ ne@@ k@@ do@@ ch@@ isch	sy@@ ne@@ c@@ do@@ ch@@ ically
ach@@ ter@@ bahn	roll@@ er@@ co@@ aster
visi@@ on@@ ären	visi@@ on@@ ary
er@@ fasst	cap@@ tures
selbst@@ -@@ an@@ ordnung	self-@@ assem@@ bly
kreu@@ z@@ ungen	inter@@ se@@ ctions
bio@@ fabri@@ kation	bio@@ fabri@@ cation
reichen	stre@@ tch
ge@@ pflan@@ zt	plan@@ ted
er@@ wachen	a@@ wa@@ ken@@ ing
super@@ organis@@ mus	super@@ organis@@ m
musi@@ kal@@ isches	ton@@ e-@@ dea@@ f
konzep@@ tion@@ eller	concep@@ tual
über@@ le@@ genheit	ma@@ ster@@ y
platt@@ ent@@ ek@@ ton@@ ik	te@@ c@@ ton@@ ics
bedürf@@ tigen	nee@@ dy
ein@@ schä@@ tzung	as@@ s@@ ess@@ ment
sub@@ klin@@ ische	sub@@ clinical
an@@ frage	requ@@ est
kei@@ me	ger@@ ms
prin@@ zen	prin@@ ces
rief	ph@@ oned
ge@@ ha@@ ckt	ha@@ cked
sozi@@ alisierung	soci@@ alization
kre@@ di@@ t@@ kar@@ ten@@ informationen	credit
mittel@@ ozean@@ ische	mi@@ d-@@ ocean
er@@ haltung	preser@@ vation
kehr@@ seite	fli@@ p
new@@ ton@@ schen	new@@ ton@@ ian
be@@ ur@@ teilt	jud@@ ged
einzel@@ handel	re@@ tail
emp@@ fehl@@ ung	re@@ com@@ men@@ dation
beeinflus@@ sende	per@@ su@@ asi@@ ve
sat@@ tel@@ förmi@@ ge	sa@@ dd@@ le-@@ sha@@ ped
span@@ n@@ weite	w@@ ing@@ sp@@ an
wen@@ de@@ punkt	in@@ fle@@ ction
bewer@@ tung	re@@ view
forsch@@ erin	resear@@ cher
philosop@@ hi@@ en	philosop@@ hi@@ es
pir@@ aten	pir@@ ates
ver@@ hand@@ l@@ ung@@ stisch	negoti@@ ating
hoffnung	as@@ pi@@ ration
or@@ th@@ op@@ ä@@ di@@ e-@@ zentrum	or@@ th@@ op@@ edi@@ c
la@@ ger@@ feuer	cam@@ p@@ fire
astro@@ log@@ ie	astro@@ log@@ y
aus@@ führen	ex@@ ec@@ ute
lam@@ pen	lam@@ ps
r@@ ön@@ t@@ gen@@ bilder	x-@@ ra@@ ys
sonnen@@ bri@@ llen	sun@@ glas@@ ses
zivili@@ sa@@ tions@@ staat	civili@@ za@@ tion@@ -@@ state
k@@ lebte	pa@@ sted
kü@@ sten@@ ebene	co@@ ast@@ al
unter@@ le@@ genen	under@@ dog
gelö@@ scht	del@@ et@@ ed
trag@@ is@@ cher@@ weise	tra@@ gi@@ cally
un@@ besch@@ rie@@ ben@@ es	s@@ late
ent@@ wur@@ f	dra@@ ft
besch@@ werden	com@@ pla@@ in@@ ts
fuß@@ gän@@ ger	pe@@ de@@ stri@@ ans
gur@@ ken@@ f@@ ass	pi@@ ck@@ le
ge@@ handelt	tra@@ ded
fes@@ sel@@ nden	ri@@ v@@ eting
guten	high-@@ per@@ forming
12@@ -@@ jähri@@ ger	12@@ -year-old
quant@@ ent@@ un@@ n@@ eln	tun@@ nel@@ ing
mau@@ er@@ werk	ma@@ son@@ ry
don@@ ner@@ stag	th@@ ur@@ s@@ day
sam@@ en-@@ ka@@ the@@ dr@@ ale	se@@ ed
aus@@ zeichnungen	a@@ wards
regu@@ liert	regul@@ ated
geräu@@ sch@@ ku@@ li@@ ssen	so@@ und@@ scap@@ es
geräu@@ sch@@ ku@@ li@@ sse	so@@ und@@ scap@@ e
auf@@ erle@@ gt	im@@ posed
zwei@@ -@@ sechs	two-@@ six
atem@@ weg@@ ser@@ krank@@ ungen	res@@ pir@@ atory
acht@@ jähri@@ ger	ei@@ ght-@@ year-old
schneiden	cutting
geschw@@ om@@ men	s@@ w@@ um
schwi@@ mm@@ bri@@ lle	go@@ g@@ gles
ko@@ ch@@ buch	coo@@ k@@ book
qu@@ anten@@ -@@ ar@@ reti@@ erung	lo@@ cking
lebens@@ zeit	life@@ times
er@@ leu@@ ch@@ te@@ tes	en@@ ligh@@ ten@@ ed
ben@@ en@@ nen	nom@@ in@@ ate
unglaublichen	un@@ belie@@ vable
lebens@@ langen	li@@ fel@@ ong
m@@ ja@@ m	go@@ b@@ ble
dra@@ mati@@ ker	play@@ w@@ right
haupt@@ mo@@ tiv	theme
ab@@ len@@ k@@ end	di@@ stra@@ cting
gesch@@ ni@@ tten	sli@@ ced
impf@@ ung	imm@@ uni@@ zation
stamm@@ baum	b@@ loo@@ d@@ line
pig@@ men@@ tierte	pig@@ mented
dun@@ kel	dar@@ k@@ ly
mor@@ dr@@ aten	hom@@ i@@ cide
psycho@@ se	psycho@@ tic
re@@ gent@@ rop@@ fen	rain@@ dro@@ ps
ver@@ jün@@ gung	re@@ ju@@ ven@@ ation
in@@ aktivität	in@@ activity
er@@ lauf@@ baren	wal@@ k@@ able
na@@ hen	mi@@ d-@@ east
ge@@ fol@@ g@@ schaften	alle@@ gi@@ an@@ ces
am@@ t@@ str@@ ä@@ ger	bri@@ ber@@ y
astro@@ lab@@ ien	astro@@ lab@@ es
grund@@ begri@@ ffe	bas@@ ics
ta@@ ges@@ stä@@ tten	da@@ y@@ care
respe@@ kt@@ lo@@ sigkeit	ir@@ rever@@ ence
lo@@ ch@@ karten	pun@@ ch
kal@@ b	cal@@ f
still@@ en	bre@@ ast@@ fe@@ eding
beein@@ tr@@ äch@@ tigt	com@@ promis@@ ed
in@@ fizieren	infe@@ ct
mu@@ sch@@ el@@ ver@@ gif@@ tung	sh@@ ell@@ fish
ver@@ stop@@ ft	clo@@ g@@ ged
rei@@ ter	ri@@ der
ur@@ groß@@ vater	great@@ -@@ grand@@ father
gegen@@ stücke	counter@@ parts
wieder@@ ver@@ wer@@ tet	recycl@@ ed
mü@@ ll@@ hal@@ de	du@@ mp
ein@@ kauf@@ s@@ zentr@@ en	m@@ alls
ver@@ nach@@ lässi@@ gung	ne@@ g@@ le@@ ct
hydro@@ kultur	hydro@@ po@@ ni@@ cs
pat@@ enti@@ eren	pat@@ enting
selbst@@ zerstör@@ er@@ ische	self-@@ de@@ struc@@ tive
mein@@ ungs@@ verschieden@@ heit	dis@@ agre@@ ement
kapit@@ alisten	capit@@ alists
gerü@@ chte	ru@@ mor@@ s
augen@@ brau@@ e	e@@ ye@@ bro@@ w
an@@ hän@@ ger@@ schaft	const@@ it@@ u@@ ency
einflus@@ s@@ reiche	influ@@ enti@@ al
pflich@@ ten	du@@ ties
predi@@ gten	ser@@ mon@@ s
my@@ stischen	my@@ sti@@ cal
ko@@ sm@@ ologen	co@@ sm@@ ologists
gegen@@ über@@ stellung	ju@@ x@@ ta@@ position
unge@@ wollte	un@@ wanted
einge@@ treten	enter@@ ed
höch@@ ste	t@@ all@@ est
holz@@ ameisen	car@@ p@@ enter
z@@ wie@@ b@@ eln	oni@@ ons
ver@@ sie@@ gel@@ t	se@@ aled
verschmu@@ tzen	po@@ ll@@ ute
in@@ effektiv	in@@ effective
ge@@ br@@ ä@@ u	con@@ co@@ ction
flug@@ zeu@@ gs	plane
elektron@@ isch	electr@@ on@@ ically
proto@@ kol@@ le	proto@@ col@@ s
ab@@ satz	par@@ ag@@ ra@@ ph
bot@@ ani@@ ker	bot@@ an@@ ist
ver@@ samm@@ lung	gather@@ ing
argu@@ men@@ tieren	argu@@ ing
barri@@ er@@ ef@@ rei@@ heit	acc@@ essi@@ bility
bau@@ ka@@ sten	k@@ it
charak@@ teri@@ stischen	characteri@@ stic
ge@@ de@@ hnt	stre@@ t@@ ched
ab@@ wes@@ end	ab@@ sent
unge@@ mein	im@@ men@@ sely
gei@@ stig	san@@ e
er@@ lei@@ chter@@ t	re@@ lie@@ ved
geome@@ tr@@ ischen	ge@@ om@@ et@@ ri@@ cal
feuer@@ werk	fire@@ works
einzel@@ lige	sing@@ le-@@ cell@@ ed
blin@@ ken	flas@@ hing
mikrosk@@ op@@ e	microscop@@ es
ein@@ trag	ent@@ ry
schlei@@ fen	lo@@ ops
über@@ wäl@@ ti@@ gend	min@@ d-@@ blo@@ wing
mikro@@ biologie	micro@@ biology
stei@@ gern	increasing
mathemati@@ sches	reas@@ oning
tran@@ sa@@ ktion	trans@@ action
tele@@ präsen@@ z	tele@@ pres@@ ence
er@@ fri@@ erungen	fro@@ st@@ bi@@ te
mo@@ ti@@ va@@ tionen	mo@@ ti@@ va@@ tions
bes@@ ei@@ tigung	elimin@@ ating
über@@ treiben	over@@ do
ent@@ gegen	contr@@ ary
viet@@ nam@@ es@@ ischen	viet@@ nam@@ ese
ermu@@ ti@@ gende	encoura@@ ging
psycho@@ soziale	psycho@@ -@@ social
starke	sever@@ e
effizi@@ enter	effici@@ ently
ver@@ fe@@ chter	ad@@ vo@@ cate
ver@@ lie@@ hen	awar@@ ded
identi@@ fi@@ kation	identi@@ fication
be@@ har@@ r@@ lichkeit	per@@ sever@@ ance
char@@ is@@ mati@@ sche	char@@ is@@ matic
ru@@ he@@ stand	reti@@ red
ver@@ e@@ hren	wor@@ ship
wo@@ hnen	assi@@ sted
aller@@ g@@ isch	aller@@ gic
spezi@@ alist	speci@@ alist
ge@@ plan@@ ten	sch@@ ed@@ ul@@ ed
tau@@ schen	tra@@ ding
klas@@ si@@ fizieren	classi@@ fy
klas@@ si@@ fiziert	classi@@ fied
